Table,State,Distt.,Area Name,Type,Age-group,Total,illiterate,literate
C2308,00,000,INDIA,Total,All ages,587584719,258709529,328875190
C2308,00,000,INDIA,Total,0-6,78762999,78762999,0
C2308,00,000,INDIA,Total,7,11923276,3359531,8563745
C2308,00,000,INDIA,Total,8,12906436,2117672,10788764
C2308,00,000,INDIA,Total,9,11209653,1293565,9916088
C2308,00,000,INDIA,Total,10,14462671,1793381,12669290
C2308,00,000,INDIA,Total,11,11778342,1059145,10719197
C2308,00,000,INDIA,Total,12,13239415,1304209,11935206
C2308,00,000,INDIA,Total,13,11716908,1019553,10697355
C2308,00,000,INDIA,Total,14,12093041,1180325,10912716
C2308,00,000,INDIA,Total,15,12159708,1423331,10736377
C2308,00,000,INDIA,Total,16,11564358,1401609,10162749
C2308,00,000,INDIA,Total,17,9868018,1158414,8709604
C2308,00,000,INDIA,Total,18,12937296,2195787,10741509
C2308,00,000,INDIA,Total,19,10014673,1643220,8371453
C2308,00,000,INDIA,Total,20-24,53839529,12212466,41627063
C2308,00,000,INDIA,Total,25-29,50069757,15072101,34997656
C2308,00,000,INDIA,Total,30-34,43934277,16298810,27635467
C2308,00,000,INDIA,Total,35-39,42221303,18524159,23697144
C2308,00,000,INDIA,Total,40-44,34892726,17151840,17740886
C2308,00,000,INDIA,Total,45-49,30180213,16062247,14117966
C2308,00,000,INDIA,Total,50-54,23225988,13021195,10204793
C2308,00,000,INDIA,Total,55-59,19690043,11976353,7713690
C2308,00,000,INDIA,Total,60-64,18961958,12964714,5997244
C2308,00,000,INDIA,Total,65-69,13510657,9684474,3826183
C2308,00,000,INDIA,Total,70-74,9557343,7198872,2358471
C2308,00,000,INDIA,Total,75-79,4741900,3470507,1271393
C2308,00,000,INDIA,Total,80+,6005310,4433955,1571355
C2308,00,000,INDIA,Total,Age not stated,2116921,925095,1191826
C2308,00,000,INDIA,Rural,All ages,405967794,204535333,201432461
C2308,00,000,INDIA,Rural,0-6,58238416,58238416,0
C2308,00,000,INDIA,Rural,7,8750077,2652818,6097259
C2308,00,000,INDIA,Rural,8,9709963,1726252,7983711
C2308,00,000,INDIA,Rural,9,8234180,1034038,7200142
C2308,00,000,INDIA,Rural,10,10788008,1445468,9342540
C2308,00,000,INDIA,Rural,11,8531715,842741,7688974
C2308,00,000,INDIA,Rural,12,9807869,1067023,8740846
C2308,00,000,INDIA,Rural,13,8465789,822354,7643435
C2308,00,000,INDIA,Rural,14,8722955,953256,7769699
C2308,00,000,INDIA,Rural,15,8719978,1159111,7560867
C2308,00,000,INDIA,Rural,16,8180014,1139537,7040477
C2308,00,000,INDIA,Rural,17,6694496,929697,5764799
C2308,00,000,INDIA,Rural,18,9040991,1817804,7223187
C2308,00,000,INDIA,Rural,19,6696436,1350082,5346354
C2308,00,000,INDIA,Rural,20-24,35696384,10113829,25582555
C2308,00,000,INDIA,Rural,25-29,32692281,12453366,20238915
C2308,00,000,INDIA,Rural,30-34,28977587,13478048,15499539
C2308,00,000,INDIA,Rural,35-39,27937146,15121108,12816038
C2308,00,000,INDIA,Rural,40-44,23015773,13921319,9094454
C2308,00,000,INDIA,Rural,45-49,19823958,12940097,6883861
C2308,00,000,INDIA,Rural,50-54,15242241,10462697,4779544
C2308,00,000,INDIA,Rural,55-59,13324985,9746203,3578782
C2308,00,000,INDIA,Rural,60-64,13359653,10565428,2794225
C2308,00,000,INDIA,Rural,65-69,9707959,7913667,1794292
C2308,00,000,INDIA,Rural,70-74,6829421,5784666,1044755
C2308,00,000,INDIA,Rural,75-79,3270293,2743508,526785
C2308,00,000,INDIA,Rural,80+,4129194,3417606,711588
C2308,00,000,INDIA,Rural,Age not stated,1380032,695194,684838
C2308,00,000,INDIA,Urban,All ages,181616925,54174196,127442729
C2308,00,000,INDIA,Urban,0-6,20524583,20524583,0
C2308,00,000,INDIA,Urban,7,3173199,706713,2466486
C2308,00,000,INDIA,Urban,8,3196473,391420,2805053
C2308,00,000,INDIA,Urban,9,2975473,259527,2715946
C2308,00,000,INDIA,Urban,10,3674663,347913,3326750
C2308,00,000,INDIA,Urban,11,3246627,216404,3030223
C2308,00,000,INDIA,Urban,12,3431546,237186,3194360
C2308,00,000,INDIA,Urban,13,3251119,197199,3053920
C2308,00,000,INDIA,Urban,14,3370086,227069,3143017
C2308,00,000,INDIA,Urban,15,3439730,264220,3175510
C2308,00,000,INDIA,Urban,16,3384344,262072,3122272
C2308,00,000,INDIA,Urban,17,3173522,228717,2944805
C2308,00,000,INDIA,Urban,18,3896305,377983,3518322
C2308,00,000,INDIA,Urban,19,3318237,293138,3025099
C2308,00,000,INDIA,Urban,20-24,18143145,2098637,16044508
C2308,00,000,INDIA,Urban,25-29,17377476,2618735,14758741
C2308,00,000,INDIA,Urban,30-34,14956690,2820762,12135928
C2308,00,000,INDIA,Urban,35-39,14284157,3403051,10881106
C2308,00,000,INDIA,Urban,40-44,11876953,3230521,8646432
C2308,00,000,INDIA,Urban,45-49,10356255,3122150,7234105
C2308,00,000,INDIA,Urban,50-54,7983747,2558498,5425249
C2308,00,000,INDIA,Urban,55-59,6365058,2230150,4134908
C2308,00,000,INDIA,Urban,60-64,5602305,2399286,3203019
C2308,00,000,INDIA,Urban,65-69,3802698,1770807,2031891
C2308,00,000,INDIA,Urban,70-74,2727922,1414206,1313716
C2308,00,000,INDIA,Urban,75-79,1471607,726999,744608
C2308,00,000,INDIA,Urban,80+,1876116,1016349,859767
C2308,00,000,INDIA,Urban,Age not stated,736889,229901,506988
C2308,01,000,State - JAMMU & KASHMIR,Total,All ages,5900640,3098078,2802562
C2308,01,000,State - JAMMU & KASHMIR,Total,0-6,934550,934550,0
C2308,01,000,State - JAMMU & KASHMIR,Total,7,128415,45715,82700
C2308,01,000,State - JAMMU & KASHMIR,Total,8,134844,31087,103757
C2308,01,000,State - JAMMU & KASHMIR,Total,9,118729,20617,98112
C2308,01,000,State - JAMMU & KASHMIR,Total,10,147510,27667,119843
C2308,01,000,State - JAMMU & KASHMIR,Total,11,132788,19044,113744
C2308,01,000,State - JAMMU & KASHMIR,Total,12,137433,19126,118307
C2308,01,000,State - JAMMU & KASHMIR,Total,13,124351,15936,108415
C2308,01,000,State - JAMMU & KASHMIR,Total,14,126916,17074,109842
C2308,01,000,State - JAMMU & KASHMIR,Total,15,130490,21089,109401
C2308,01,000,State - JAMMU & KASHMIR,Total,16,126964,21730,105234
C2308,01,000,State - JAMMU & KASHMIR,Total,17,106198,17805,88393
C2308,01,000,State - JAMMU & KASHMIR,Total,18,134386,30190,104196
C2308,01,000,State - JAMMU & KASHMIR,Total,19,99062,21077,77985
C2308,01,000,State - JAMMU & KASHMIR,Total,20-24,557335,162292,395043
C2308,01,000,State - JAMMU & KASHMIR,Total,25-29,501563,197100,304463
C2308,01,000,State - JAMMU & KASHMIR,Total,30-34,431157,206465,224692
C2308,01,000,State - JAMMU & KASHMIR,Total,35-39,396680,222794,173886
C2308,01,000,State - JAMMU & KASHMIR,Total,40-44,326346,208019,118327
C2308,01,000,State - JAMMU & KASHMIR,Total,45-49,279230,192274,86956
C2308,01,000,State - JAMMU & KASHMIR,Total,50-54,212967,154989,57978
C2308,01,000,State - JAMMU & KASHMIR,Total,55-59,167278,129052,38226
C2308,01,000,State - JAMMU & KASHMIR,Total,60-64,149299,124161,25138
C2308,01,000,State - JAMMU & KASHMIR,Total,65-69,101222,87008,14214
C2308,01,000,State - JAMMU & KASHMIR,Total,70-74,86547,77621,8926
C2308,01,000,State - JAMMU & KASHMIR,Total,75-79,41982,37459,4523
C2308,01,000,State - JAMMU & KASHMIR,Total,80+,61026,53587,7439
C2308,01,000,State - JAMMU & KASHMIR,Total,Age not stated,5372,2550,2822
C2308,01,000,State - JAMMU & KASHMIR,Rural,All ages,4333583,2477382,1856201
C2308,01,000,State - JAMMU & KASHMIR,Rural,0-6,738867,738867,0
C2308,01,000,State - JAMMU & KASHMIR,Rural,7,100775,38232,62543
C2308,01,000,State - JAMMU & KASHMIR,Rural,8,106165,26360,79805
C2308,01,000,State - JAMMU & KASHMIR,Rural,9,92653,17450,75203
C2308,01,000,State - JAMMU & KASHMIR,Rural,10,115644,23349,92295
C2308,01,000,State - JAMMU & KASHMIR,Rural,11,104224,16223,88001
C2308,01,000,State - JAMMU & KASHMIR,Rural,12,107675,16510,91165
C2308,01,000,State - JAMMU & KASHMIR,Rural,13,96663,13802,82861
C2308,01,000,State - JAMMU & KASHMIR,Rural,14,97519,14672,82847
C2308,01,000,State - JAMMU & KASHMIR,Rural,15,100355,18392,81963
C2308,01,000,State - JAMMU & KASHMIR,Rural,16,96777,18962,77815
C2308,01,000,State - JAMMU & KASHMIR,Rural,17,78896,15353,63543
C2308,01,000,State - JAMMU & KASHMIR,Rural,18,100679,26297,74382
C2308,01,000,State - JAMMU & KASHMIR,Rural,19,72303,18076,54227
C2308,01,000,State - JAMMU & KASHMIR,Rural,20-24,404069,138034,266035
C2308,01,000,State - JAMMU & KASHMIR,Rural,25-29,353024,163407,189617
C2308,01,000,State - JAMMU & KASHMIR,Rural,30-34,303075,168448,134627
C2308,01,000,State - JAMMU & KASHMIR,Rural,35-39,274557,177352,97205
C2308,01,000,State - JAMMU & KASHMIR,Rural,40-44,226234,165246,60988
C2308,01,000,State - JAMMU & KASHMIR,Rural,45-49,190923,151365,39558
C2308,01,000,State - JAMMU & KASHMIR,Rural,50-54,146188,122245,23943
C2308,01,000,State - JAMMU & KASHMIR,Rural,55-59,112854,98900,13954
C2308,01,000,State - JAMMU & KASHMIR,Rural,60-64,104765,95688,9077
C2308,01,000,State - JAMMU & KASHMIR,Rural,65-69,69940,65239,4701
C2308,01,000,State - JAMMU & KASHMIR,Rural,70-74,61307,58280,3027
C2308,01,000,State - JAMMU & KASHMIR,Rural,75-79,28938,27496,1442
C2308,01,000,State - JAMMU & KASHMIR,Rural,80+,44530,41135,3395
C2308,01,000,State - JAMMU & KASHMIR,Rural,Age not stated,3984,2002,1982
C2308,01,000,State - JAMMU & KASHMIR,Urban,All ages,1567057,620696,946361
C2308,01,000,State - JAMMU & KASHMIR,Urban,0-6,195683,195683,0
C2308,01,000,State - JAMMU & KASHMIR,Urban,7,27640,7483,20157
C2308,01,000,State - JAMMU & KASHMIR,Urban,8,28679,4727,23952
C2308,01,000,State - JAMMU & KASHMIR,Urban,9,26076,3167,22909
C2308,01,000,State - JAMMU & KASHMIR,Urban,10,31866,4318,27548
C2308,01,000,State - JAMMU & KASHMIR,Urban,11,28564,2821,25743
C2308,01,000,State - JAMMU & KASHMIR,Urban,12,29758,2616,27142
C2308,01,000,State - JAMMU & KASHMIR,Urban,13,27688,2134,25554
C2308,01,000,State - JAMMU & KASHMIR,Urban,14,29397,2402,26995
C2308,01,000,State - JAMMU & KASHMIR,Urban,15,30135,2697,27438
C2308,01,000,State - JAMMU & KASHMIR,Urban,16,30187,2768,27419
C2308,01,000,State - JAMMU & KASHMIR,Urban,17,27302,2452,24850
C2308,01,000,State - JAMMU & KASHMIR,Urban,18,33707,3893,29814
C2308,01,000,State - JAMMU & KASHMIR,Urban,19,26759,3001,23758
C2308,01,000,State - JAMMU & KASHMIR,Urban,20-24,153266,24258,129008
C2308,01,000,State - JAMMU & KASHMIR,Urban,25-29,148539,33693,114846
C2308,01,000,State - JAMMU & KASHMIR,Urban,30-34,128082,38017,90065
C2308,01,000,State - JAMMU & KASHMIR,Urban,35-39,122123,45442,76681
C2308,01,000,State - JAMMU & KASHMIR,Urban,40-44,100112,42773,57339
C2308,01,000,State - JAMMU & KASHMIR,Urban,45-49,88307,40909,47398
C2308,01,000,State - JAMMU & KASHMIR,Urban,50-54,66779,32744,34035
C2308,01,000,State - JAMMU & KASHMIR,Urban,55-59,54424,30152,24272
C2308,01,000,State - JAMMU & KASHMIR,Urban,60-64,44534,28473,16061
C2308,01,000,State - JAMMU & KASHMIR,Urban,65-69,31282,21769,9513
C2308,01,000,State - JAMMU & KASHMIR,Urban,70-74,25240,19341,5899
C2308,01,000,State - JAMMU & KASHMIR,Urban,75-79,13044,9963,3081
C2308,01,000,State - JAMMU & KASHMIR,Urban,80+,16496,12452,4044
C2308,01,000,State - JAMMU & KASHMIR,Urban,Age not stated,1388,548,840
C2308,02,000,State - HIMACHAL PRADESH,Total,All ages,3382729,1095583,2287146
C2308,02,000,State - HIMACHAL PRADESH,Total,0-6,370439,370439,0
C2308,02,000,State - HIMACHAL PRADESH,Total,7,58197,9478,48719
C2308,02,000,State - HIMACHAL PRADESH,Total,8,55531,3157,52374
C2308,02,000,State - HIMACHAL PRADESH,Total,9,55526,2274,53252
C2308,02,000,State - HIMACHAL PRADESH,Total,10,62949,3048,59901
C2308,02,000,State - HIMACHAL PRADESH,Total,11,59754,1877,57877
C2308,02,000,State - HIMACHAL PRADESH,Total,12,59031,1472,57559
C2308,02,000,State - HIMACHAL PRADESH,Total,13,58789,1365,57424
C2308,02,000,State - HIMACHAL PRADESH,Total,14,60461,1430,59031
C2308,02,000,State - HIMACHAL PRADESH,Total,15,60153,1714,58439
C2308,02,000,State - HIMACHAL PRADESH,Total,16,59752,1537,58215
C2308,02,000,State - HIMACHAL PRADESH,Total,17,58864,1483,57381
C2308,02,000,State - HIMACHAL PRADESH,Total,18,64494,2301,62193
C2308,02,000,State - HIMACHAL PRADESH,Total,19,60469,2114,58355
C2308,02,000,State - HIMACHAL PRADESH,Total,20-24,320146,17271,302875
C2308,02,000,State - HIMACHAL PRADESH,Total,25-29,299035,26688,272347
C2308,02,000,State - HIMACHAL PRADESH,Total,30-34,275104,36431,238673
C2308,02,000,State - HIMACHAL PRADESH,Total,35-39,259736,52693,207043
C2308,02,000,State - HIMACHAL PRADESH,Total,40-44,223291,66245,157046
C2308,02,000,State - HIMACHAL PRADESH,Total,45-49,197486,72310,125176
C2308,02,000,State - HIMACHAL PRADESH,Total,50-54,164963,72807,92156
C2308,02,000,State - HIMACHAL PRADESH,Total,55-59,131615,67815,63800
C2308,02,000,State - HIMACHAL PRADESH,Total,60-64,115908,77260,38648
C2308,02,000,State - HIMACHAL PRADESH,Total,65-69,80220,59933,20287
C2308,02,000,State - HIMACHAL PRADESH,Total,70-74,68468,56341,12127
C2308,02,000,State - HIMACHAL PRADESH,Total,75-79,39266,33350,5916
C2308,02,000,State - HIMACHAL PRADESH,Total,80+,58272,51142,7130
C2308,02,000,State - HIMACHAL PRADESH,Total,Age not stated,4810,1608,3202
C2308,02,000,State - HIMACHAL PRADESH,Rural,All ages,3065705,1031790,2033915
C2308,02,000,State - HIMACHAL PRADESH,Rural,0-6,339968,339968,0
C2308,02,000,State - HIMACHAL PRADESH,Rural,7,53171,8617,44554
C2308,02,000,State - HIMACHAL PRADESH,Rural,8,50577,2858,47719
C2308,02,000,State - HIMACHAL PRADESH,Rural,9,50590,2054,48536
C2308,02,000,State - HIMACHAL PRADESH,Rural,10,57482,2753,54729
C2308,02,000,State - HIMACHAL PRADESH,Rural,11,54507,1682,52825
C2308,02,000,State - HIMACHAL PRADESH,Rural,12,53913,1315,52598
C2308,02,000,State - HIMACHAL PRADESH,Rural,13,53673,1215,52458
C2308,02,000,State - HIMACHAL PRADESH,Rural,14,55190,1278,53912
C2308,02,000,State - HIMACHAL PRADESH,Rural,15,54671,1515,53156
C2308,02,000,State - HIMACHAL PRADESH,Rural,16,54335,1373,52962
C2308,02,000,State - HIMACHAL PRADESH,Rural,17,53324,1365,51959
C2308,02,000,State - HIMACHAL PRADESH,Rural,18,58515,2080,56435
C2308,02,000,State - HIMACHAL PRADESH,Rural,19,54592,1918,52674
C2308,02,000,State - HIMACHAL PRADESH,Rural,20-24,288272,15554,272718
C2308,02,000,State - HIMACHAL PRADESH,Rural,25-29,268589,24497,244092
C2308,02,000,State - HIMACHAL PRADESH,Rural,30-34,246103,34028,212075
C2308,02,000,State - HIMACHAL PRADESH,Rural,35-39,231369,49826,181543
C2308,02,000,State - HIMACHAL PRADESH,Rural,40-44,199498,63294,136204
C2308,02,000,State - HIMACHAL PRADESH,Rural,45-49,177304,69342,107962
C2308,02,000,State - HIMACHAL PRADESH,Rural,50-54,149619,70204,79415
C2308,02,000,State - HIMACHAL PRADESH,Rural,55-59,120095,65484,54611
C2308,02,000,State - HIMACHAL PRADESH,Rural,60-64,106932,74690,32242
C2308,02,000,State - HIMACHAL PRADESH,Rural,65-69,74146,57907,16239
C2308,02,000,State - HIMACHAL PRADESH,Rural,70-74,63682,54273,9409
C2308,02,000,State - HIMACHAL PRADESH,Rural,75-79,36397,31984,4413
C2308,02,000,State - HIMACHAL PRADESH,Rural,80+,54704,49164,5540
C2308,02,000,State - HIMACHAL PRADESH,Rural,Age not stated,4487,1552,2935
C2308,02,000,State - HIMACHAL PRADESH,Urban,All ages,317024,63793,253231
C2308,02,000,State - HIMACHAL PRADESH,Urban,0-6,30471,30471,0
C2308,02,000,State - HIMACHAL PRADESH,Urban,7,5026,861,4165
C2308,02,000,State - HIMACHAL PRADESH,Urban,8,4954,299,4655
C2308,02,000,State - HIMACHAL PRADESH,Urban,9,4936,220,4716
C2308,02,000,State - HIMACHAL PRADESH,Urban,10,5467,295,5172
C2308,02,000,State - HIMACHAL PRADESH,Urban,11,5247,195,5052
C2308,02,000,State - HIMACHAL PRADESH,Urban,12,5118,157,4961
C2308,02,000,State - HIMACHAL PRADESH,Urban,13,5116,150,4966
C2308,02,000,State - HIMACHAL PRADESH,Urban,14,5271,152,5119
C2308,02,000,State - HIMACHAL PRADESH,Urban,15,5482,199,5283
C2308,02,000,State - HIMACHAL PRADESH,Urban,16,5417,164,5253
C2308,02,000,State - HIMACHAL PRADESH,Urban,17,5540,118,5422
C2308,02,000,State - HIMACHAL PRADESH,Urban,18,5979,221,5758
C2308,02,000,State - HIMACHAL PRADESH,Urban,19,5877,196,5681
C2308,02,000,State - HIMACHAL PRADESH,Urban,20-24,31874,1717,30157
C2308,02,000,State - HIMACHAL PRADESH,Urban,25-29,30446,2191,28255
C2308,02,000,State - HIMACHAL PRADESH,Urban,30-34,29001,2403,26598
C2308,02,000,State - HIMACHAL PRADESH,Urban,35-39,28367,2867,25500
C2308,02,000,State - HIMACHAL PRADESH,Urban,40-44,23793,2951,20842
C2308,02,000,State - HIMACHAL PRADESH,Urban,45-49,20182,2968,17214
C2308,02,000,State - HIMACHAL PRADESH,Urban,50-54,15344,2603,12741
C2308,02,000,State - HIMACHAL PRADESH,Urban,55-59,11520,2331,9189
C2308,02,000,State - HIMACHAL PRADESH,Urban,60-64,8976,2570,6406
C2308,02,000,State - HIMACHAL PRADESH,Urban,65-69,6074,2026,4048
C2308,02,000,State - HIMACHAL PRADESH,Urban,70-74,4786,2068,2718
C2308,02,000,State - HIMACHAL PRADESH,Urban,75-79,2869,1366,1503
C2308,02,000,State - HIMACHAL PRADESH,Urban,80+,3568,1978,1590
C2308,02,000,State - HIMACHAL PRADESH,Urban,Age not stated,323,56,267
C2308,03,000,State - PUNJAB,Total,All ages,13103873,4832792,8271081
C2308,03,000,State - PUNJAB,Total,0-6,1410225,1410225,0
C2308,03,000,State - PUNJAB,Total,7,220853,50517,170336
C2308,03,000,State - PUNJAB,Total,8,215613,26633,188980
C2308,03,000,State - PUNJAB,Total,9,203219,18205,185014
C2308,03,000,State - PUNJAB,Total,10,233267,22353,210914
C2308,03,000,State - PUNJAB,Total,11,213274,14798,198476
C2308,03,000,State - PUNJAB,Total,12,227788,16539,211249
C2308,03,000,State - PUNJAB,Total,13,227353,15525,211828
C2308,03,000,State - PUNJAB,Total,14,236190,17279,218911
C2308,03,000,State - PUNJAB,Total,15,245771,21361,224410
C2308,03,000,State - PUNJAB,Total,16,250175,21107,229068
C2308,03,000,State - PUNJAB,Total,17,237455,18268,219187
C2308,03,000,State - PUNJAB,Total,18,276032,28115,247917
C2308,03,000,State - PUNJAB,Total,19,238070,21741,216329
C2308,03,000,State - PUNJAB,Total,20-24,1311105,172443,1138662
C2308,03,000,State - PUNJAB,Total,25-29,1193456,225047,968409
C2308,03,000,State - PUNJAB,Total,30-34,1034006,268759,765247
C2308,03,000,State - PUNJAB,Total,35-39,978209,315240,662969
C2308,03,000,State - PUNJAB,Total,40-44,879261,325984,553277
C2308,03,000,State - PUNJAB,Total,45-49,769636,313625,456011
C2308,03,000,State - PUNJAB,Total,50-54,590800,259947,330853
C2308,03,000,State - PUNJAB,Total,55-59,470710,234012,236698
C2308,03,000,State - PUNJAB,Total,60-64,514107,323574,190533
C2308,03,000,State - PUNJAB,Total,65-69,346782,244111,102671
C2308,03,000,State - PUNJAB,Total,70-74,241352,183788,57564
C2308,03,000,State - PUNJAB,Total,75-79,126463,98887,27576
C2308,03,000,State - PUNJAB,Total,80+,193451,157536,35915
C2308,03,000,State - PUNJAB,Total,Age not stated,19250,7173,12077
C2308,03,000,State - PUNJAB,Rural,All ages,8250716,3411866,4838850
C2308,03,000,State - PUNJAB,Rural,0-6,890205,890205,0
C2308,03,000,State - PUNJAB,Rural,7,140944,32584,108360
C2308,03,000,State - PUNJAB,Rural,8,138615,16496,122119
C2308,03,000,State - PUNJAB,Rural,9,130738,11014,119724
C2308,03,000,State - PUNJAB,Rural,10,148780,13507,135273
C2308,03,000,State - PUNJAB,Rural,11,137011,9053,127958
C2308,03,000,State - PUNJAB,Rural,12,147877,10277,137600
C2308,03,000,State - PUNJAB,Rural,13,149015,9928,139087
C2308,03,000,State - PUNJAB,Rural,14,154779,11371,143408
C2308,03,000,State - PUNJAB,Rural,15,161088,14163,146925
C2308,03,000,State - PUNJAB,Rural,16,164826,14200,150626
C2308,03,000,State - PUNJAB,Rural,17,154984,12299,142685
C2308,03,000,State - PUNJAB,Rural,18,178798,18951,159847
C2308,03,000,State - PUNJAB,Rural,19,150900,14392,136508
C2308,03,000,State - PUNJAB,Rural,20-24,818094,117174,700920
C2308,03,000,State - PUNJAB,Rural,25-29,717260,154711,562549
C2308,03,000,State - PUNJAB,Rural,30-34,627238,191832,435406
C2308,03,000,State - PUNJAB,Rural,35-39,598593,228677,369916
C2308,03,000,State - PUNJAB,Rural,40-44,546738,240832,305906
C2308,03,000,State - PUNJAB,Rural,45-49,469359,232638,236721
C2308,03,000,State - PUNJAB,Rural,50-54,351994,194156,157838
C2308,03,000,State - PUNJAB,Rural,55-59,285350,178281,107069
C2308,03,000,State - PUNJAB,Rural,60-64,344904,256442,88462
C2308,03,000,State - PUNJAB,Rural,65-69,238287,193196,45091
C2308,03,000,State - PUNJAB,Rural,70-74,164996,141705,23291
C2308,03,000,State - PUNJAB,Rural,75-79,86608,76055,10553
C2308,03,000,State - PUNJAB,Rural,80+,138958,122256,16702
C2308,03,000,State - PUNJAB,Rural,Age not stated,13777,5471,8306
C2308,03,000,State - PUNJAB,Urban,All ages,4853157,1420926,3432231
C2308,03,000,State - PUNJAB,Urban,0-6,520020,520020,0
C2308,03,000,State - PUNJAB,Urban,7,79909,17933,61976
C2308,03,000,State - PUNJAB,Urban,8,76998,10137,66861
C2308,03,000,State - PUNJAB,Urban,9,72481,7191,65290
C2308,03,000,State - PUNJAB,Urban,10,84487,8846,75641
C2308,03,000,State - PUNJAB,Urban,11,76263,5745,70518
C2308,03,000,State - PUNJAB,Urban,12,79911,6262,73649
C2308,03,000,State - PUNJAB,Urban,13,78338,5597,72741
C2308,03,000,State - PUNJAB,Urban,14,81411,5908,75503
C2308,03,000,State - PUNJAB,Urban,15,84683,7198,77485
C2308,03,000,State - PUNJAB,Urban,16,85349,6907,78442
C2308,03,000,State - PUNJAB,Urban,17,82471,5969,76502
C2308,03,000,State - PUNJAB,Urban,18,97234,9164,88070
C2308,03,000,State - PUNJAB,Urban,19,87170,7349,79821
C2308,03,000,State - PUNJAB,Urban,20-24,493011,55269,437742
C2308,03,000,State - PUNJAB,Urban,25-29,476196,70336,405860
C2308,03,000,State - PUNJAB,Urban,30-34,406768,76927,329841
C2308,03,000,State - PUNJAB,Urban,35-39,379616,86563,293053
C2308,03,000,State - PUNJAB,Urban,40-44,332523,85152,247371
C2308,03,000,State - PUNJAB,Urban,45-49,300277,80987,219290
C2308,03,000,State - PUNJAB,Urban,50-54,238806,65791,173015
C2308,03,000,State - PUNJAB,Urban,55-59,185360,55731,129629
C2308,03,000,State - PUNJAB,Urban,60-64,169203,67132,102071
C2308,03,000,State - PUNJAB,Urban,65-69,108495,50915,57580
C2308,03,000,State - PUNJAB,Urban,70-74,76356,42083,34273
C2308,03,000,State - PUNJAB,Urban,75-79,39855,22832,17023
C2308,03,000,State - PUNJAB,Urban,80+,54493,35280,19213
C2308,03,000,State - PUNJAB,Urban,Age not stated,5473,1702,3771
C2308,04,000,State - CHANDIGARH,Total,All ages,474787,134695,340092
C2308,04,000,State - CHANDIGARH,Total,0-6,55898,55898,0
C2308,04,000,State - CHANDIGARH,Total,7,8637,1523,7114
C2308,04,000,State - CHANDIGARH,Total,8,7858,657,7201
C2308,04,000,State - CHANDIGARH,Total,9,8053,705,7348
C2308,04,000,State - CHANDIGARH,Total,10,8950,771,8179
C2308,04,000,State - CHANDIGARH,Total,11,8116,484,7632
C2308,04,000,State - CHANDIGARH,Total,12,8212,437,7775
C2308,04,000,State - CHANDIGARH,Total,13,7906,422,7484
C2308,04,000,State - CHANDIGARH,Total,14,8140,423,7717
C2308,04,000,State - CHANDIGARH,Total,15,8335,559,7776
C2308,04,000,State - CHANDIGARH,Total,16,8438,549,7889
C2308,04,000,State - CHANDIGARH,Total,17,7977,492,7485
C2308,04,000,State - CHANDIGARH,Total,18,9868,745,9123
C2308,04,000,State - CHANDIGARH,Total,19,9279,630,8649
C2308,04,000,State - CHANDIGARH,Total,20-24,52777,5616,47161
C2308,04,000,State - CHANDIGARH,Total,25-29,49543,8173,41370
C2308,04,000,State - CHANDIGARH,Total,30-34,41178,8953,32225
C2308,04,000,State - CHANDIGARH,Total,35-39,38106,10024,28082
C2308,04,000,State - CHANDIGARH,Total,40-44,31653,8880,22773
C2308,04,000,State - CHANDIGARH,Total,45-49,27459,7644,19815
C2308,04,000,State - CHANDIGARH,Total,50-54,20834,5503,15331
C2308,04,000,State - CHANDIGARH,Total,55-59,15180,4007,11173
C2308,04,000,State - CHANDIGARH,Total,60-64,12271,4235,8036
C2308,04,000,State - CHANDIGARH,Total,65-69,7589,2572,5017
C2308,04,000,State - CHANDIGARH,Total,70-74,5387,1950,3437
C2308,04,000,State - CHANDIGARH,Total,75-79,3167,1073,2094
C2308,04,000,State - CHANDIGARH,Total,80+,3831,1719,2112
C2308,04,000,State - CHANDIGARH,Total,Age not stated,145,51,94
C2308,04,000,State - CHANDIGARH,Rural,All ages,11841,4632,7209
C2308,04,000,State - CHANDIGARH,Rural,0-6,1988,1988,0
C2308,04,000,State - CHANDIGARH,Rural,7,264,60,204
C2308,04,000,State - CHANDIGARH,Rural,8,257,27,230
C2308,04,000,State - CHANDIGARH,Rural,9,250,28,222
C2308,04,000,State - CHANDIGARH,Rural,10,265,34,231
C2308,04,000,State - CHANDIGARH,Rural,11,245,23,222
C2308,04,000,State - CHANDIGARH,Rural,12,200,17,183
C2308,04,000,State - CHANDIGARH,Rural,13,195,14,181
C2308,04,000,State - CHANDIGARH,Rural,14,211,21,190
C2308,04,000,State - CHANDIGARH,Rural,15,210,22,188
C2308,04,000,State - CHANDIGARH,Rural,16,181,21,160
C2308,04,000,State - CHANDIGARH,Rural,17,177,16,161
C2308,04,000,State - CHANDIGARH,Rural,18,205,23,182
C2308,04,000,State - CHANDIGARH,Rural,19,205,31,174
C2308,04,000,State - CHANDIGARH,Rural,20-24,1338,237,1101
C2308,04,000,State - CHANDIGARH,Rural,25-29,1546,365,1181
C2308,04,000,State - CHANDIGARH,Rural,30-34,1199,357,842
C2308,04,000,State - CHANDIGARH,Rural,35-39,866,306,560
C2308,04,000,State - CHANDIGARH,Rural,40-44,600,244,356
C2308,04,000,State - CHANDIGARH,Rural,45-49,411,176,235
C2308,04,000,State - CHANDIGARH,Rural,50-54,308,144,164
C2308,04,000,State - CHANDIGARH,Rural,55-59,231,121,110
C2308,04,000,State - CHANDIGARH,Rural,60-64,204,139,65
C2308,04,000,State - CHANDIGARH,Rural,65-69,115,86,29
C2308,04,000,State - CHANDIGARH,Rural,70-74,85,63,22
C2308,04,000,State - CHANDIGARH,Rural,75-79,32,27,5
C2308,04,000,State - CHANDIGARH,Rural,80+,51,41,10
C2308,04,000,State - CHANDIGARH,Rural,Age not stated,2,1,1
C2308,04,000,State - CHANDIGARH,Urban,All ages,462946,130063,332883
C2308,04,000,State - CHANDIGARH,Urban,0-6,53910,53910,0
C2308,04,000,State - CHANDIGARH,Urban,7,8373,1463,6910
C2308,04,000,State - CHANDIGARH,Urban,8,7601,630,6971
C2308,04,000,State - CHANDIGARH,Urban,9,7803,677,7126
C2308,04,000,State - CHANDIGARH,Urban,10,8685,737,7948
C2308,04,000,State - CHANDIGARH,Urban,11,7871,461,7410
C2308,04,000,State - CHANDIGARH,Urban,12,8012,420,7592
C2308,04,000,State - CHANDIGARH,Urban,13,7711,408,7303
C2308,04,000,State - CHANDIGARH,Urban,14,7929,402,7527
C2308,04,000,State - CHANDIGARH,Urban,15,8125,537,7588
C2308,04,000,State - CHANDIGARH,Urban,16,8257,528,7729
C2308,04,000,State - CHANDIGARH,Urban,17,7800,476,7324
C2308,04,000,State - CHANDIGARH,Urban,18,9663,722,8941
C2308,04,000,State - CHANDIGARH,Urban,19,9074,599,8475
C2308,04,000,State - CHANDIGARH,Urban,20-24,51439,5379,46060
C2308,04,000,State - CHANDIGARH,Urban,25-29,47997,7808,40189
C2308,04,000,State - CHANDIGARH,Urban,30-34,39979,8596,31383
C2308,04,000,State - CHANDIGARH,Urban,35-39,37240,9718,27522
C2308,04,000,State - CHANDIGARH,Urban,40-44,31053,8636,22417
C2308,04,000,State - CHANDIGARH,Urban,45-49,27048,7468,19580
C2308,04,000,State - CHANDIGARH,Urban,50-54,20526,5359,15167
C2308,04,000,State - CHANDIGARH,Urban,55-59,14949,3886,11063
C2308,04,000,State - CHANDIGARH,Urban,60-64,12067,4096,7971
C2308,04,000,State - CHANDIGARH,Urban,65-69,7474,2486,4988
C2308,04,000,State - CHANDIGARH,Urban,70-74,5302,1887,3415
C2308,04,000,State - CHANDIGARH,Urban,75-79,3135,1046,2089
C2308,04,000,State - CHANDIGARH,Urban,80+,3780,1678,2102
C2308,04,000,State - CHANDIGARH,Urban,Age not stated,143,50,93
C2308,05,000,State - UTTARAKHAND,Total,All ages,4948519,1931274,3017245
C2308,05,000,State - UTTARAKHAND,Total,0-6,638615,638615,0
C2308,05,000,State - UTTARAKHAND,Total,7,99785,22131,77654
C2308,05,000,State - UTTARAKHAND,Total,8,102048,10555,91493
C2308,05,000,State - UTTARAKHAND,Total,9,94050,7282,86768
C2308,05,000,State - UTTARAKHAND,Total,10,116189,10347,105842
C2308,05,000,State - UTTARAKHAND,Total,11,101011,5688,95323
C2308,05,000,State - UTTARAKHAND,Total,12,111517,5303,106214
C2308,05,000,State - UTTARAKHAND,Total,13,103545,4652,98893
C2308,05,000,State - UTTARAKHAND,Total,14,109807,5421,104386
C2308,05,000,State - UTTARAKHAND,Total,15,112207,7009,105198
C2308,05,000,State - UTTARAKHAND,Total,16,110854,7206,103648
C2308,05,000,State - UTTARAKHAND,Total,17,98392,6420,91972
C2308,05,000,State - UTTARAKHAND,Total,18,119066,10678,108388
C2308,05,000,State - UTTARAKHAND,Total,19,95108,8056,87052
C2308,05,000,State - UTTARAKHAND,Total,20-24,485454,63294,422160
C2308,05,000,State - UTTARAKHAND,Total,25-29,412821,84676,328145
C2308,05,000,State - UTTARAKHAND,Total,30-34,352873,102333,250540
C2308,05,000,State - UTTARAKHAND,Total,35-39,334666,125242,209424
C2308,05,000,State - UTTARAKHAND,Total,40-44,281178,124896,156282
C2308,05,000,State - UTTARAKHAND,Total,45-49,241395,120204,121191
C2308,05,000,State - UTTARAKHAND,Total,50-54,195134,107175,87959
C2308,05,000,State - UTTARAKHAND,Total,55-59,166596,102857,63739
C2308,05,000,State - UTTARAKHAND,Total,60-64,165836,118983,46853
C2308,05,000,State - UTTARAKHAND,Total,65-69,110347,82481,27866
C2308,05,000,State - UTTARAKHAND,Total,70-74,82473,66219,16254
C2308,05,000,State - UTTARAKHAND,Total,75-79,43809,35599,8210
C2308,05,000,State - UTTARAKHAND,Total,80+,56447,45441,11006
C2308,05,000,State - UTTARAKHAND,Total,Age not stated,7296,2511,4785
C2308,05,000,State - UTTARAKHAND,Rural,All ages,3517912,1500033,2017879
C2308,05,000,State - UTTARAKHAND,Rural,0-6,468984,468984,0
C2308,05,000,State - UTTARAKHAND,Rural,7,72999,16269,56730
C2308,05,000,State - UTTARAKHAND,Rural,8,75103,7545,67558
C2308,05,000,State - UTTARAKHAND,Rural,9,69597,5127,64470
C2308,05,000,State - UTTARAKHAND,Rural,10,85520,7103,78417
C2308,05,000,State - UTTARAKHAND,Rural,11,74778,3869,70909
C2308,05,000,State - UTTARAKHAND,Rural,12,83124,3521,79603
C2308,05,000,State - UTTARAKHAND,Rural,13,76791,3082,73709
C2308,05,000,State - UTTARAKHAND,Rural,14,80627,3593,77034
C2308,05,000,State - UTTARAKHAND,Rural,15,82025,4715,77310
C2308,05,000,State - UTTARAKHAND,Rural,16,80897,4918,75979
C2308,05,000,State - UTTARAKHAND,Rural,17,70190,4383,65807
C2308,05,000,State - UTTARAKHAND,Rural,18,85170,7523,77647
C2308,05,000,State - UTTARAKHAND,Rural,19,67547,5688,61859
C2308,05,000,State - UTTARAKHAND,Rural,20-24,335596,45903,289693
C2308,05,000,State - UTTARAKHAND,Rural,25-29,276477,62850,213627
C2308,05,000,State - UTTARAKHAND,Rural,30-34,237266,78927,158339
C2308,05,000,State - UTTARAKHAND,Rural,35-39,226106,97934,128172
C2308,05,000,State - UTTARAKHAND,Rural,40-44,191592,99553,92039
C2308,05,000,State - UTTARAKHAND,Rural,45-49,164945,96492,68453
C2308,05,000,State - UTTARAKHAND,Rural,50-54,137037,88510,48527
C2308,05,000,State - UTTARAKHAND,Rural,55-59,120404,85964,34440
C2308,05,000,State - UTTARAKHAND,Rural,60-64,125528,101259,24269
C2308,05,000,State - UTTARAKHAND,Rural,65-69,84262,70443,13819
C2308,05,000,State - UTTARAKHAND,Rural,70-74,64302,56548,7754
C2308,05,000,State - UTTARAKHAND,Rural,75-79,33864,30285,3579
C2308,05,000,State - UTTARAKHAND,Rural,80+,42457,37267,5190
C2308,05,000,State - UTTARAKHAND,Rural,Age not stated,4724,1778,2946
C2308,05,000,State - UTTARAKHAND,Urban,All ages,1430607,431241,999366
C2308,05,000,State - UTTARAKHAND,Urban,0-6,169631,169631,0
C2308,05,000,State - UTTARAKHAND,Urban,7,26786,5862,20924
C2308,05,000,State - UTTARAKHAND,Urban,8,26945,3010,23935
C2308,05,000,State - UTTARAKHAND,Urban,9,24453,2155,22298
C2308,05,000,State - UTTARAKHAND,Urban,10,30669,3244,27425
C2308,05,000,State - UTTARAKHAND,Urban,11,26233,1819,24414
C2308,05,000,State - UTTARAKHAND,Urban,12,28393,1782,26611
C2308,05,000,State - UTTARAKHAND,Urban,13,26754,1570,25184
C2308,05,000,State - UTTARAKHAND,Urban,14,29180,1828,27352
C2308,05,000,State - UTTARAKHAND,Urban,15,30182,2294,27888
C2308,05,000,State - UTTARAKHAND,Urban,16,29957,2288,27669
C2308,05,000,State - UTTARAKHAND,Urban,17,28202,2037,26165
C2308,05,000,State - UTTARAKHAND,Urban,18,33896,3155,30741
C2308,05,000,State - UTTARAKHAND,Urban,19,27561,2368,25193
C2308,05,000,State - UTTARAKHAND,Urban,20-24,149858,17391,132467
C2308,05,000,State - UTTARAKHAND,Urban,25-29,136344,21826,114518
C2308,05,000,State - UTTARAKHAND,Urban,30-34,115607,23406,92201
C2308,05,000,State - UTTARAKHAND,Urban,35-39,108560,27308,81252
C2308,05,000,State - UTTARAKHAND,Urban,40-44,89586,25343,64243
C2308,05,000,State - UTTARAKHAND,Urban,45-49,76450,23712,52738
C2308,05,000,State - UTTARAKHAND,Urban,50-54,58097,18665,39432
C2308,05,000,State - UTTARAKHAND,Urban,55-59,46192,16893,29299
C2308,05,000,State - UTTARAKHAND,Urban,60-64,40308,17724,22584
C2308,05,000,State - UTTARAKHAND,Urban,65-69,26085,12038,14047
C2308,05,000,State - UTTARAKHAND,Urban,70-74,18171,9671,8500
C2308,05,000,State - UTTARAKHAND,Urban,75-79,9945,5314,4631
C2308,05,000,State - UTTARAKHAND,Urban,80+,13990,8174,5816
C2308,05,000,State - UTTARAKHAND,Urban,Age not stated,2572,733,1839
C2308,06,000,State - HARYANA,Total,All ages,11856728,5051807,6804921
C2308,06,000,State - HARYANA,Total,0-6,1537612,1537612,0
C2308,06,000,State - HARYANA,Total,7,226755,50094,176661
C2308,06,000,State - HARYANA,Total,8,232252,29400,202852
C2308,06,000,State - HARYANA,Total,9,209043,19521,189522
C2308,06,000,State - HARYANA,Total,10,253384,26140,227244
C2308,06,000,State - HARYANA,Total,11,224845,16513,208332
C2308,06,000,State - HARYANA,Total,12,245137,19145,225992
C2308,06,000,State - HARYANA,Total,13,231454,16683,214771
C2308,06,000,State - HARYANA,Total,14,239722,19616,220106
C2308,06,000,State - HARYANA,Total,15,247651,22284,225367
C2308,06,000,State - HARYANA,Total,16,242802,22878,219924
C2308,06,000,State - HARYANA,Total,17,216151,19869,196282
C2308,06,000,State - HARYANA,Total,18,266823,33414,233409
C2308,06,000,State - HARYANA,Total,19,216415,25882,190533
C2308,06,000,State - HARYANA,Total,20-24,1194687,196704,997983
C2308,06,000,State - HARYANA,Total,25-29,1053619,236621,816998
C2308,06,000,State - HARYANA,Total,30-34,916747,283441,633306
C2308,06,000,State - HARYANA,Total,35-39,849146,357193,491953
C2308,06,000,State - HARYANA,Total,40-44,715369,373675,341694
C2308,06,000,State - HARYANA,Total,45-49,586065,340729,245336
C2308,06,000,State - HARYANA,Total,50-54,454540,279134,175406
C2308,06,000,State - HARYANA,Total,55-59,376729,248879,127850
C2308,06,000,State - HARYANA,Total,60-64,430391,321791,108600
C2308,06,000,State - HARYANA,Total,65-69,249169,193746,55423
C2308,06,000,State - HARYANA,Total,70-74,185857,152516,33341
C2308,06,000,State - HARYANA,Total,75-79,98525,82353,16172
C2308,06,000,State - HARYANA,Total,80+,141192,119764,21428
C2308,06,000,State - HARYANA,Total,Age not stated,14646,6210,8436
C2308,06,000,State - HARYANA,Rural,All ages,7735353,3717010,4018343
C2308,06,000,State - HARYANA,Rural,0-6,1040022,1040022,0
C2308,06,000,State - HARYANA,Rural,7,152148,33974,118174
C2308,06,000,State - HARYANA,Rural,8,158037,20016,138021
C2308,06,000,State - HARYANA,Rural,9,141503,13036,128467
C2308,06,000,State - HARYANA,Rural,10,171899,17651,154248
C2308,06,000,State - HARYANA,Rural,11,153569,11409,142160
C2308,06,000,State - HARYANA,Rural,12,168345,13560,154785
C2308,06,000,State - HARYANA,Rural,13,158541,11968,146573
C2308,06,000,State - HARYANA,Rural,14,164419,14274,150145
C2308,06,000,State - HARYANA,Rural,15,169608,16292,153316
C2308,06,000,State - HARYANA,Rural,16,166525,16877,149648
C2308,06,000,State - HARYANA,Rural,17,145315,14714,130601
C2308,06,000,State - HARYANA,Rural,18,180284,24782,155502
C2308,06,000,State - HARYANA,Rural,19,143868,19098,124770
C2308,06,000,State - HARYANA,Rural,20-24,769002,143144,625858
C2308,06,000,State - HARYANA,Rural,25-29,646512,170002,476510
C2308,06,000,State - HARYANA,Rural,30-34,568791,210425,358366
C2308,06,000,State - HARYANA,Rural,35-39,528103,269900,258203
C2308,06,000,State - HARYANA,Rural,40-44,451413,289163,162250
C2308,06,000,State - HARYANA,Rural,45-49,361716,262141,99575
C2308,06,000,State - HARYANA,Rural,50-54,279793,215741,64052
C2308,06,000,State - HARYANA,Rural,55-59,238544,194695,43849
C2308,06,000,State - HARYANA,Rural,60-64,297321,258600,38721
C2308,06,000,State - HARYANA,Rural,65-69,171688,154236,17452
C2308,06,000,State - HARYANA,Rural,70-74,129624,119871,9753
C2308,06,000,State - HARYANA,Rural,75-79,68863,64392,4471
C2308,06,000,State - HARYANA,Rural,80+,100330,92558,7772
C2308,06,000,State - HARYANA,Rural,Age not stated,9570,4469,5101
C2308,06,000,State - HARYANA,Urban,All ages,4121375,1334797,2786578
C2308,06,000,State - HARYANA,Urban,0-6,497590,497590,0
C2308,06,000,State - HARYANA,Urban,7,74607,16120,58487
C2308,06,000,State - HARYANA,Urban,8,74215,9384,64831
C2308,06,000,State - HARYANA,Urban,9,67540,6485,61055
C2308,06,000,State - HARYANA,Urban,10,81485,8489,72996
C2308,06,000,State - HARYANA,Urban,11,71276,5104,66172
C2308,06,000,State - HARYANA,Urban,12,76792,5585,71207
C2308,06,000,State - HARYANA,Urban,13,72913,4715,68198
C2308,06,000,State - HARYANA,Urban,14,75303,5342,69961
C2308,06,000,State - HARYANA,Urban,15,78043,5992,72051
C2308,06,000,State - HARYANA,Urban,16,76277,6001,70276
C2308,06,000,State - HARYANA,Urban,17,70836,5155,65681
C2308,06,000,State - HARYANA,Urban,18,86539,8632,77907
C2308,06,000,State - HARYANA,Urban,19,72547,6784,65763
C2308,06,000,State - HARYANA,Urban,20-24,425685,53560,372125
C2308,06,000,State - HARYANA,Urban,25-29,407107,66619,340488
C2308,06,000,State - HARYANA,Urban,30-34,347956,73016,274940
C2308,06,000,State - HARYANA,Urban,35-39,321043,87293,233750
C2308,06,000,State - HARYANA,Urban,40-44,263956,84512,179444
C2308,06,000,State - HARYANA,Urban,45-49,224349,78588,145761
C2308,06,000,State - HARYANA,Urban,50-54,174747,63393,111354
C2308,06,000,State - HARYANA,Urban,55-59,138185,54184,84001
C2308,06,000,State - HARYANA,Urban,60-64,133070,63191,69879
C2308,06,000,State - HARYANA,Urban,65-69,77481,39510,37971
C2308,06,000,State - HARYANA,Urban,70-74,56233,32645,23588
C2308,06,000,State - HARYANA,Urban,75-79,29662,17961,11701
C2308,06,000,State - HARYANA,Urban,80+,40862,27206,13656
C2308,06,000,State - HARYANA,Urban,Age not stated,5076,1741,3335
C2308,07,000,State - NCT OF DELHI,Total,All ages,7800615,2257704,5542911
C2308,07,000,State - NCT OF DELHI,Total,0-6,937014,937014,0
C2308,07,000,State - NCT OF DELHI,Total,7,142530,28707,113823
C2308,07,000,State - NCT OF DELHI,Total,8,141635,12378,129257
C2308,07,000,State - NCT OF DELHI,Total,9,132170,8867,123303
C2308,07,000,State - NCT OF DELHI,Total,10,163789,11689,152100
C2308,07,000,State - NCT OF DELHI,Total,11,142958,6464,136494
C2308,07,000,State - NCT OF DELHI,Total,12,152546,6322,146224
C2308,07,000,State - NCT OF DELHI,Total,13,143679,5431,138248
C2308,07,000,State - NCT OF DELHI,Total,14,149729,6271,143458
C2308,07,000,State - NCT OF DELHI,Total,15,151604,7684,143920
C2308,07,000,State - NCT OF DELHI,Total,16,148387,7572,140815
C2308,07,000,State - NCT OF DELHI,Total,17,138103,6908,131195
C2308,07,000,State - NCT OF DELHI,Total,18,166264,11968,154296
C2308,07,000,State - NCT OF DELHI,Total,19,137899,8869,129030
C2308,07,000,State - NCT OF DELHI,Total,20-24,812649,82481,730168
C2308,07,000,State - NCT OF DELHI,Total,25-29,790130,114162,675968
C2308,07,000,State - NCT OF DELHI,Total,30-34,677244,131620,545624
C2308,07,000,State - NCT OF DELHI,Total,35-39,620789,155945,464844
C2308,07,000,State - NCT OF DELHI,Total,40-44,506339,146047,360292
C2308,07,000,State - NCT OF DELHI,Total,45-49,415986,126972,289014
C2308,07,000,State - NCT OF DELHI,Total,50-54,311247,95390,215857
C2308,07,000,State - NCT OF DELHI,Total,55-59,239707,80476,159231
C2308,07,000,State - NCT OF DELHI,Total,60-64,233916,101800,132116
C2308,07,000,State - NCT OF DELHI,Total,65-69,133054,57031,76023
C2308,07,000,State - NCT OF DELHI,Total,70-74,94303,43849,50454
C2308,07,000,State - NCT OF DELHI,Total,75-79,50247,22387,27860
C2308,07,000,State - NCT OF DELHI,Total,80+,59170,30952,28218
C2308,07,000,State - NCT OF DELHI,Total,Age not stated,7527,2448,5079
C2308,07,000,State - NCT OF DELHI,Rural,All ages,192721,70448,122273
C2308,07,000,State - NCT OF DELHI,Rural,0-6,25457,25457,0
C2308,07,000,State - NCT OF DELHI,Rural,7,3804,745,3059
C2308,07,000,State - NCT OF DELHI,Rural,8,3829,337,3492
C2308,07,000,State - NCT OF DELHI,Rural,9,3450,230,3220
C2308,07,000,State - NCT OF DELHI,Rural,10,4648,355,4293
C2308,07,000,State - NCT OF DELHI,Rural,11,3792,202,3590
C2308,07,000,State - NCT OF DELHI,Rural,12,4183,209,3974
C2308,07,000,State - NCT OF DELHI,Rural,13,3782,141,3641
C2308,07,000,State - NCT OF DELHI,Rural,14,3999,195,3804
C2308,07,000,State - NCT OF DELHI,Rural,15,4082,269,3813
C2308,07,000,State - NCT OF DELHI,Rural,16,4001,230,3771
C2308,07,000,State - NCT OF DELHI,Rural,17,3504,211,3293
C2308,07,000,State - NCT OF DELHI,Rural,18,4367,425,3942
C2308,07,000,State - NCT OF DELHI,Rural,19,3497,304,3193
C2308,07,000,State - NCT OF DELHI,Rural,20-24,20602,2588,18014
C2308,07,000,State - NCT OF DELHI,Rural,25-29,18666,3348,15318
C2308,07,000,State - NCT OF DELHI,Rural,30-34,16402,4059,12343
C2308,07,000,State - NCT OF DELHI,Rural,35-39,14910,4954,9956
C2308,07,000,State - NCT OF DELHI,Rural,40-44,11782,4997,6785
C2308,07,000,State - NCT OF DELHI,Rural,45-49,8695,4219,4476
C2308,07,000,State - NCT OF DELHI,Rural,50-54,6430,3458,2972
C2308,07,000,State - NCT OF DELHI,Rural,55-59,4927,2942,1985
C2308,07,000,State - NCT OF DELHI,Rural,60-64,5924,4157,1767
C2308,07,000,State - NCT OF DELHI,Rural,65-69,2998,2310,688
C2308,07,000,State - NCT OF DELHI,Rural,70-74,2147,1779,368
C2308,07,000,State - NCT OF DELHI,Rural,75-79,1067,936,131
C2308,07,000,State - NCT OF DELHI,Rural,80+,1540,1307,233
C2308,07,000,State - NCT OF DELHI,Rural,Age not stated,236,84,152
C2308,07,000,State - NCT OF DELHI,Urban,All ages,7607894,2187256,5420638
C2308,07,000,State - NCT OF DELHI,Urban,0-6,911557,911557,0
C2308,07,000,State - NCT OF DELHI,Urban,7,138726,27962,110764
C2308,07,000,State - NCT OF DELHI,Urban,8,137806,12041,125765
C2308,07,000,State - NCT OF DELHI,Urban,9,128720,8637,120083
C2308,07,000,State - NCT OF DELHI,Urban,10,159141,11334,147807
C2308,07,000,State - NCT OF DELHI,Urban,11,139166,6262,132904
C2308,07,000,State - NCT OF DELHI,Urban,12,148363,6113,142250
C2308,07,000,State - NCT OF DELHI,Urban,13,139897,5290,134607
C2308,07,000,State - NCT OF DELHI,Urban,14,145730,6076,139654
C2308,07,000,State - NCT OF DELHI,Urban,15,147522,7415,140107
C2308,07,000,State - NCT OF DELHI,Urban,16,144386,7342,137044
C2308,07,000,State - NCT OF DELHI,Urban,17,134599,6697,127902
C2308,07,000,State - NCT OF DELHI,Urban,18,161897,11543,150354
C2308,07,000,State - NCT OF DELHI,Urban,19,134402,8565,125837
C2308,07,000,State - NCT OF DELHI,Urban,20-24,792047,79893,712154
C2308,07,000,State - NCT OF DELHI,Urban,25-29,771464,110814,660650
C2308,07,000,State - NCT OF DELHI,Urban,30-34,660842,127561,533281
C2308,07,000,State - NCT OF DELHI,Urban,35-39,605879,150991,454888
C2308,07,000,State - NCT OF DELHI,Urban,40-44,494557,141050,353507
C2308,07,000,State - NCT OF DELHI,Urban,45-49,407291,122753,284538
C2308,07,000,State - NCT OF DELHI,Urban,50-54,304817,91932,212885
C2308,07,000,State - NCT OF DELHI,Urban,55-59,234780,77534,157246
C2308,07,000,State - NCT OF DELHI,Urban,60-64,227992,97643,130349
C2308,07,000,State - NCT OF DELHI,Urban,65-69,130056,54721,75335
C2308,07,000,State - NCT OF DELHI,Urban,70-74,92156,42070,50086
C2308,07,000,State - NCT OF DELHI,Urban,75-79,49180,21451,27729
C2308,07,000,State - NCT OF DELHI,Urban,80+,57630,29645,27985
C2308,07,000,State - NCT OF DELHI,Urban,Age not stated,7291,2364,4927
C2308,08,000,State - RAJASTHAN,Total,All ages,32997440,18410570,14586870
C2308,08,000,State - RAJASTHAN,Total,0-6,5010328,5010328,0
C2308,08,000,State - RAJASTHAN,Total,7,721301,238913,482388
C2308,08,000,State - RAJASTHAN,Total,8,835396,169901,665495
C2308,08,000,State - RAJASTHAN,Total,9,660436,96907,563529
C2308,08,000,State - RAJASTHAN,Total,10,927195,150735,776460
C2308,08,000,State - RAJASTHAN,Total,11,711707,88051,623656
C2308,08,000,State - RAJASTHAN,Total,12,844767,125709,719058
C2308,08,000,State - RAJASTHAN,Total,13,727456,102522,624934
C2308,08,000,State - RAJASTHAN,Total,14,738697,112511,626186
C2308,08,000,State - RAJASTHAN,Total,15,751875,133860,618015
C2308,08,000,State - RAJASTHAN,Total,16,724333,134177,590156
C2308,08,000,State - RAJASTHAN,Total,17,569266,104965,464301
C2308,08,000,State - RAJASTHAN,Total,18,825909,220078,605831
C2308,08,000,State - RAJASTHAN,Total,19,552760,146060,406700
C2308,08,000,State - RAJASTHAN,Total,20-24,3049011,1118943,1930068
C2308,08,000,State - RAJASTHAN,Total,25-29,2585438,1253542,1331896
C2308,08,000,State - RAJASTHAN,Total,30-34,2338114,1353734,984380
C2308,08,000,State - RAJASTHAN,Total,35-39,2132774,1391886,740888
C2308,08,000,State - RAJASTHAN,Total,40-44,1808439,1271936,536503
C2308,08,000,State - RAJASTHAN,Total,45-49,1536892,1139997,396895
C2308,08,000,State - RAJASTHAN,Total,50-54,1171801,893242,278559
C2308,08,000,State - RAJASTHAN,Total,55-59,961583,765748,195835
C2308,08,000,State - RAJASTHAN,Total,60-64,886115,739213,146902
C2308,08,000,State - RAJASTHAN,Total,65-69,670905,576521,94384
C2308,08,000,State - RAJASTHAN,Total,70-74,526904,468771,58133
C2308,08,000,State - RAJASTHAN,Total,75-79,261639,232231,29408
C2308,08,000,State - RAJASTHAN,Total,80+,334312,298093,36219
C2308,08,000,State - RAJASTHAN,Total,Age not stated,132087,71996,60091
C2308,08,000,State - RAJASTHAN,Rural,All ages,24858605,15291408,9567197
C2308,08,000,State - RAJASTHAN,Rural,0-6,3968284,3968284,0
C2308,08,000,State - RAJASTHAN,Rural,7,564023,196855,367168
C2308,08,000,State - RAJASTHAN,Rural,8,665311,142825,522486
C2308,08,000,State - RAJASTHAN,Rural,9,516974,80209,436765
C2308,08,000,State - RAJASTHAN,Rural,10,735755,126245,609510
C2308,08,000,State - RAJASTHAN,Rural,11,554417,73286,481131
C2308,08,000,State - RAJASTHAN,Rural,12,666519,106855,559664
C2308,08,000,State - RAJASTHAN,Rural,13,562703,86317,476386
C2308,08,000,State - RAJASTHAN,Rural,14,571063,95179,475884
C2308,08,000,State - RAJASTHAN,Rural,15,576711,113009,463702
C2308,08,000,State - RAJASTHAN,Rural,16,554029,114267,439762
C2308,08,000,State - RAJASTHAN,Rural,17,418669,88282,330387
C2308,08,000,State - RAJASTHAN,Rural,18,626083,189768,436315
C2308,08,000,State - RAJASTHAN,Rural,19,403360,125351,278009
C2308,08,000,State - RAJASTHAN,Rural,20-24,2211087,961015,1250072
C2308,08,000,State - RAJASTHAN,Rural,25-29,1850840,1072816,778024
C2308,08,000,State - RAJASTHAN,Rural,30-34,1696706,1154072,542634
C2308,08,000,State - RAJASTHAN,Rural,35-39,1544561,1175510,369051
C2308,08,000,State - RAJASTHAN,Rural,40-44,1314207,1071056,243151
C2308,08,000,State - RAJASTHAN,Rural,45-49,1115603,956095,159508
C2308,08,000,State - RAJASTHAN,Rural,50-54,849535,747359,102176
C2308,08,000,State - RAJASTHAN,Rural,55-59,715210,645702,69508
C2308,08,000,State - RAJASTHAN,Rural,60-64,677057,624073,52984
C2308,08,000,State - RAJASTHAN,Rural,65-69,522444,487550,34894
C2308,08,000,State - RAJASTHAN,Rural,70-74,412974,392817,20157
C2308,08,000,State - RAJASTHAN,Rural,75-79,202628,193198,9430
C2308,08,000,State - RAJASTHAN,Rural,80+,256021,241584,14437
C2308,08,000,State - RAJASTHAN,Rural,Age not stated,105831,61829,44002
C2308,08,000,State - RAJASTHAN,Urban,All ages,8138835,3119162,5019673
C2308,08,000,State - RAJASTHAN,Urban,0-6,1042044,1042044,0
C2308,08,000,State - RAJASTHAN,Urban,7,157278,42058,115220
C2308,08,000,State - RAJASTHAN,Urban,8,170085,27076,143009
C2308,08,000,State - RAJASTHAN,Urban,9,143462,16698,126764
C2308,08,000,State - RAJASTHAN,Urban,10,191440,24490,166950
C2308,08,000,State - RAJASTHAN,Urban,11,157290,14765,142525
C2308,08,000,State - RAJASTHAN,Urban,12,178248,18854,159394
C2308,08,000,State - RAJASTHAN,Urban,13,164753,16205,148548
C2308,08,000,State - RAJASTHAN,Urban,14,167634,17332,150302
C2308,08,000,State - RAJASTHAN,Urban,15,175164,20851,154313
C2308,08,000,State - RAJASTHAN,Urban,16,170304,19910,150394
C2308,08,000,State - RAJASTHAN,Urban,17,150597,16683,133914
C2308,08,000,State - RAJASTHAN,Urban,18,199826,30310,169516
C2308,08,000,State - RAJASTHAN,Urban,19,149400,20709,128691
C2308,08,000,State - RAJASTHAN,Urban,20-24,837924,157928,679996
C2308,08,000,State - RAJASTHAN,Urban,25-29,734598,180726,553872
C2308,08,000,State - RAJASTHAN,Urban,30-34,641408,199662,441746
C2308,08,000,State - RAJASTHAN,Urban,35-39,588213,216376,371837
C2308,08,000,State - RAJASTHAN,Urban,40-44,494232,200880,293352
C2308,08,000,State - RAJASTHAN,Urban,45-49,421289,183902,237387
C2308,08,000,State - RAJASTHAN,Urban,50-54,322266,145883,176383
C2308,08,000,State - RAJASTHAN,Urban,55-59,246373,120046,126327
C2308,08,000,State - RAJASTHAN,Urban,60-64,209058,115140,93918
C2308,08,000,State - RAJASTHAN,Urban,65-69,148461,88971,59490
C2308,08,000,State - RAJASTHAN,Urban,70-74,113930,75954,37976
C2308,08,000,State - RAJASTHAN,Urban,75-79,59011,39033,19978
C2308,08,000,State - RAJASTHAN,Urban,80+,78291,56509,21782
C2308,08,000,State - RAJASTHAN,Urban,Age not stated,26256,10167,16089
C2308,09,000,State - UTTAR PRADESH,Total,All ages,95331831,49169240,46162591
C2308,09,000,State - UTTAR PRADESH,Total,0-6,14605750,14605750,0
C2308,09,000,State - UTTAR PRADESH,Total,7,2267439,719625,1547814
C2308,09,000,State - UTTAR PRADESH,Total,8,2599422,542328,2057094
C2308,09,000,State - UTTAR PRADESH,Total,9,2054969,332627,1722342
C2308,09,000,State - UTTAR PRADESH,Total,10,2949523,484310,2465213
C2308,09,000,State - UTTAR PRADESH,Total,11,2133968,283266,1850702
C2308,09,000,State - UTTAR PRADESH,Total,12,2598983,336254,2262729
C2308,09,000,State - UTTAR PRADESH,Total,13,2131162,261322,1869840
C2308,09,000,State - UTTAR PRADESH,Total,14,2377091,322383,2054708
C2308,09,000,State - UTTAR PRADESH,Total,15,2427101,379099,2048002
C2308,09,000,State - UTTAR PRADESH,Total,16,2361441,384579,1976862
C2308,09,000,State - UTTAR PRADESH,Total,17,1827394,305609,1521785
C2308,09,000,State - UTTAR PRADESH,Total,18,2530525,542907,1987618
C2308,09,000,State - UTTAR PRADESH,Total,19,1586346,363253,1223093
C2308,09,000,State - UTTAR PRADESH,Total,20-24,8173163,2605442,5567721
C2308,09,000,State - UTTAR PRADESH,Total,25-29,7113462,3155047,3958415
C2308,09,000,State - UTTAR PRADESH,Total,30-34,6523281,3467556,3055725
C2308,09,000,State - UTTAR PRADESH,Total,35-39,6154991,3663740,2491251
C2308,09,000,State - UTTAR PRADESH,Total,40-44,4836240,3073943,1762297
C2308,09,000,State - UTTAR PRADESH,Total,45-49,4067629,2738641,1328988
C2308,09,000,State - UTTAR PRADESH,Total,50-54,3015106,2090550,924556
C2308,09,000,State - UTTAR PRADESH,Total,55-59,2837945,2132368,705577
C2308,09,000,State - UTTAR PRADESH,Total,60-64,2736420,2181862,554558
C2308,09,000,State - UTTAR PRADESH,Total,65-69,1881497,1538789,342708
C2308,09,000,State - UTTAR PRADESH,Total,70-74,1297276,1093113,204163
C2308,09,000,State - UTTAR PRADESH,Total,75-79,611015,509902,101113
C2308,09,000,State - UTTAR PRADESH,Total,80+,876563,686345,190218
C2308,09,000,State - UTTAR PRADESH,Total,Age not stated,756129,368630,387499
C2308,09,000,State - UTTAR PRADESH,Rural,All ages,74324283,40833291,33490992
C2308,09,000,State - UTTAR PRADESH,Rural,0-6,11904988,11904988,0
C2308,09,000,State - UTTAR PRADESH,Rural,7,1832918,575771,1257147
C2308,09,000,State - UTTAR PRADESH,Rural,8,2133484,427455,1706029
C2308,09,000,State - UTTAR PRADESH,Rural,9,1662323,254461,1407862
C2308,09,000,State - UTTAR PRADESH,Rural,10,2410602,373947,2036655
C2308,09,000,State - UTTAR PRADESH,Rural,11,1710911,212437,1498474
C2308,09,000,State - UTTAR PRADESH,Rural,12,2103769,254692,1849077
C2308,09,000,State - UTTAR PRADESH,Rural,13,1700283,195691,1504592
C2308,09,000,State - UTTAR PRADESH,Rural,14,1886053,241428,1644625
C2308,09,000,State - UTTAR PRADESH,Rural,15,1923572,291830,1631742
C2308,09,000,State - UTTAR PRADESH,Rural,16,1848847,293741,1555106
C2308,09,000,State - UTTAR PRADESH,Rural,17,1388492,233374,1155118
C2308,09,000,State - UTTAR PRADESH,Rural,18,1949087,431146,1517941
C2308,09,000,State - UTTAR PRADESH,Rural,19,1175668,288250,887418
C2308,09,000,State - UTTAR PRADESH,Rural,20-24,6061343,2154824,3906519
C2308,09,000,State - UTTAR PRADESH,Rural,25-29,5329277,2675463,2653814
C2308,09,000,State - UTTAR PRADESH,Rural,30-34,4985338,2971018,2014320
C2308,09,000,State - UTTAR PRADESH,Rural,35-39,4675493,3111762,1563731
C2308,09,000,State - UTTAR PRADESH,Rural,40-44,3631268,2586626,1044642
C2308,09,000,State - UTTAR PRADESH,Rural,45-49,3037358,2298612,738746
C2308,09,000,State - UTTAR PRADESH,Rural,50-54,2250260,1753616,496644
C2308,09,000,State - UTTAR PRADESH,Rural,55-59,2206066,1822975,383091
C2308,09,000,State - UTTAR PRADESH,Rural,60-64,2191955,1882464,309491
C2308,09,000,State - UTTAR PRADESH,Rural,65-69,1533881,1340440,193441
C2308,09,000,State - UTTAR PRADESH,Rural,70-74,1055241,944109,111132
C2308,09,000,State - UTTAR PRADESH,Rural,75-79,494065,440749,53316
C2308,09,000,State - UTTAR PRADESH,Rural,80+,693691,581889,111802
C2308,09,000,State - UTTAR PRADESH,Rural,Age not stated,548050,289533,258517
C2308,09,000,State - UTTAR PRADESH,Urban,All ages,21007548,8335949,12671599
C2308,09,000,State - UTTAR PRADESH,Urban,0-6,2700762,2700762,0
C2308,09,000,State - UTTAR PRADESH,Urban,7,434521,143854,290667
C2308,09,000,State - UTTAR PRADESH,Urban,8,465938,114873,351065
C2308,09,000,State - UTTAR PRADESH,Urban,9,392646,78166,314480
C2308,09,000,State - UTTAR PRADESH,Urban,10,538921,110363,428558
C2308,09,000,State - UTTAR PRADESH,Urban,11,423057,70829,352228
C2308,09,000,State - UTTAR PRADESH,Urban,12,495214,81562,413652
C2308,09,000,State - UTTAR PRADESH,Urban,13,430879,65631,365248
C2308,09,000,State - UTTAR PRADESH,Urban,14,491038,80955,410083
C2308,09,000,State - UTTAR PRADESH,Urban,15,503529,87269,416260
C2308,09,000,State - UTTAR PRADESH,Urban,16,512594,90838,421756
C2308,09,000,State - UTTAR PRADESH,Urban,17,438902,72235,366667
C2308,09,000,State - UTTAR PRADESH,Urban,18,581438,111761,469677
C2308,09,000,State - UTTAR PRADESH,Urban,19,410678,75003,335675
C2308,09,000,State - UTTAR PRADESH,Urban,20-24,2111820,450618,1661202
C2308,09,000,State - UTTAR PRADESH,Urban,25-29,1784185,479584,1304601
C2308,09,000,State - UTTAR PRADESH,Urban,30-34,1537943,496538,1041405
C2308,09,000,State - UTTAR PRADESH,Urban,35-39,1479498,551978,927520
C2308,09,000,State - UTTAR PRADESH,Urban,40-44,1204972,487317,717655
C2308,09,000,State - UTTAR PRADESH,Urban,45-49,1030271,440029,590242
C2308,09,000,State - UTTAR PRADESH,Urban,50-54,764846,336934,427912
C2308,09,000,State - UTTAR PRADESH,Urban,55-59,631879,309393,322486
C2308,09,000,State - UTTAR PRADESH,Urban,60-64,544465,299398,245067
C2308,09,000,State - UTTAR PRADESH,Urban,65-69,347616,198349,149267
C2308,09,000,State - UTTAR PRADESH,Urban,70-74,242035,149004,93031
C2308,09,000,State - UTTAR PRADESH,Urban,75-79,116950,69153,47797
C2308,09,000,State - UTTAR PRADESH,Urban,80+,182872,104456,78416
C2308,09,000,State - UTTAR PRADESH,Urban,Age not stated,208079,79097,128982
C2308,10,000,State - BIHAR,Total,All ages,49821295,28924765,20896530
C2308,10,000,State - BIHAR,Total,0-6,9246725,9246725,0
C2308,10,000,State - BIHAR,Total,7,1325132,513735,811397
C2308,10,000,State - BIHAR,Total,8,1673605,437761,1235844
C2308,10,000,State - BIHAR,Total,9,1182614,256086,926528
C2308,10,000,State - BIHAR,Total,10,1821190,389761,1431429
C2308,10,000,State - BIHAR,Total,11,1129384,206449,922935
C2308,10,000,State - BIHAR,Total,12,1504957,276765,1228192
C2308,10,000,State - BIHAR,Total,13,1049840,180111,869729
C2308,10,000,State - BIHAR,Total,14,1090680,206606,884074
C2308,10,000,State - BIHAR,Total,15,1036675,236764,799911
C2308,10,000,State - BIHAR,Total,16,903830,215357,688473
C2308,10,000,State - BIHAR,Total,17,610419,152092,458327
C2308,10,000,State - BIHAR,Total,18,973158,325589,647569
C2308,10,000,State - BIHAR,Total,19,658032,241821,416211
C2308,10,000,State - BIHAR,Total,20-24,3854150,1746112,2108038
C2308,10,000,State - BIHAR,Total,25-29,3843018,2013722,1829296
C2308,10,000,State - BIHAR,Total,30-34,3545141,2007990,1537151
C2308,10,000,State - BIHAR,Total,35-39,3149100,1936389,1212711
C2308,10,000,State - BIHAR,Total,40-44,2408883,1588699,820184
C2308,10,000,State - BIHAR,Total,45-49,2060380,1458624,601756
C2308,10,000,State - BIHAR,Total,50-54,1504315,1100658,403657
C2308,10,000,State - BIHAR,Total,55-59,1466322,1135750,330572
C2308,10,000,State - BIHAR,Total,60-64,1448083,1165325,282758
C2308,10,000,State - BIHAR,Total,65-69,986061,813877,172184
C2308,10,000,State - BIHAR,Total,70-74,595148,505184,89964
C2308,10,000,State - BIHAR,Total,75-79,252506,212083,40423
C2308,10,000,State - BIHAR,Total,80+,318754,256762,61992
C2308,10,000,State - BIHAR,Total,Age not stated,183193,97968,85225
C2308,10,000,State - BIHAR,Rural,All ages,44267586,26697264,17570322
C2308,10,000,State - BIHAR,Rural,0-6,8412030,8412030,0
C2308,10,000,State - BIHAR,Rural,7,1198812,473411,725401
C2308,10,000,State - BIHAR,Rural,8,1521954,406228,1115726
C2308,10,000,State - BIHAR,Rural,9,1070505,237610,832895
C2308,10,000,State - BIHAR,Rural,10,1651713,361862,1289851
C2308,10,000,State - BIHAR,Rural,11,1013026,191546,821480
C2308,10,000,State - BIHAR,Rural,12,1351130,257532,1093598
C2308,10,000,State - BIHAR,Rural,13,932324,167657,764667
C2308,10,000,State - BIHAR,Rural,14,960779,191680,769099
C2308,10,000,State - BIHAR,Rural,15,911005,220193,690812
C2308,10,000,State - BIHAR,Rural,16,782438,199523,582915
C2308,10,000,State - BIHAR,Rural,17,518017,140398,377619
C2308,10,000,State - BIHAR,Rural,18,840695,302267,538428
C2308,10,000,State - BIHAR,Rural,19,569076,226405,342671
C2308,10,000,State - BIHAR,Rural,20-24,3366524,1635760,1730764
C2308,10,000,State - BIHAR,Rural,25-29,3382526,1885424,1497102
C2308,10,000,State - BIHAR,Rural,30-34,3128638,1879135,1249503
C2308,10,000,State - BIHAR,Rural,35-39,2768886,1803924,964962
C2308,10,000,State - BIHAR,Rural,40-44,2106292,1473427,632865
C2308,10,000,State - BIHAR,Rural,45-49,1802734,1350480,452254
C2308,10,000,State - BIHAR,Rural,50-54,1310457,1013600,296857
C2308,10,000,State - BIHAR,Rural,55-59,1298812,1052798,246014
C2308,10,000,State - BIHAR,Rural,60-64,1291723,1077871,213852
C2308,10,000,State - BIHAR,Rural,65-69,884070,754576,129494
C2308,10,000,State - BIHAR,Rural,70-74,530677,464228,66449
C2308,10,000,State - BIHAR,Rural,75-79,223733,194870,28863
C2308,10,000,State - BIHAR,Rural,80+,280532,233410,47122
C2308,10,000,State - BIHAR,Rural,Age not stated,158478,89419,69059
C2308,10,000,State - BIHAR,Urban,All ages,5553709,2227501,3326208
C2308,10,000,State - BIHAR,Urban,0-6,834695,834695,0
C2308,10,000,State - BIHAR,Urban,7,126320,40324,85996
C2308,10,000,State - BIHAR,Urban,8,151651,31533,120118
C2308,10,000,State - BIHAR,Urban,9,112109,18476,93633
C2308,10,000,State - BIHAR,Urban,10,169477,27899,141578
C2308,10,000,State - BIHAR,Urban,11,116358,14903,101455
C2308,10,000,State - BIHAR,Urban,12,153827,19233,134594
C2308,10,000,State - BIHAR,Urban,13,117516,12454,105062
C2308,10,000,State - BIHAR,Urban,14,129901,14926,114975
C2308,10,000,State - BIHAR,Urban,15,125670,16571,109099
C2308,10,000,State - BIHAR,Urban,16,121392,15834,105558
C2308,10,000,State - BIHAR,Urban,17,92402,11694,80708
C2308,10,000,State - BIHAR,Urban,18,132463,23322,109141
C2308,10,000,State - BIHAR,Urban,19,88956,15416,73540
C2308,10,000,State - BIHAR,Urban,20-24,487626,110352,377274
C2308,10,000,State - BIHAR,Urban,25-29,460492,128298,332194
C2308,10,000,State - BIHAR,Urban,30-34,416503,128855,287648
C2308,10,000,State - BIHAR,Urban,35-39,380214,132465,247749
C2308,10,000,State - BIHAR,Urban,40-44,302591,115272,187319
C2308,10,000,State - BIHAR,Urban,45-49,257646,108144,149502
C2308,10,000,State - BIHAR,Urban,50-54,193858,87058,106800
C2308,10,000,State - BIHAR,Urban,55-59,167510,82952,84558
C2308,10,000,State - BIHAR,Urban,60-64,156360,87454,68906
C2308,10,000,State - BIHAR,Urban,65-69,101991,59301,42690
C2308,10,000,State - BIHAR,Urban,70-74,64471,40956,23515
C2308,10,000,State - BIHAR,Urban,75-79,28773,17213,11560
C2308,10,000,State - BIHAR,Urban,80+,38222,23352,14870
C2308,10,000,State - BIHAR,Urban,Age not stated,24715,8549,16166
C2308,11,000,State - SIKKIM,Total,All ages,287507,93824,193683
C2308,11,000,State - SIKKIM,Total,0-6,31350,31350,0
C2308,11,000,State - SIKKIM,Total,7,5777,1260,4517
C2308,11,000,State - SIKKIM,Total,8,5497,548,4949
C2308,11,000,State - SIKKIM,Total,9,6017,574,5443
C2308,11,000,State - SIKKIM,Total,10,6614,558,6056
C2308,11,000,State - SIKKIM,Total,11,6481,316,6165
C2308,11,000,State - SIKKIM,Total,12,6554,238,6316
C2308,11,000,State - SIKKIM,Total,13,6590,236,6354
C2308,11,000,State - SIKKIM,Total,14,6719,265,6454
C2308,11,000,State - SIKKIM,Total,15,6608,333,6275
C2308,11,000,State - SIKKIM,Total,16,6761,327,6434
C2308,11,000,State - SIKKIM,Total,17,6360,320,6040
C2308,11,000,State - SIKKIM,Total,18,6907,398,6509
C2308,11,000,State - SIKKIM,Total,19,6303,359,5944
C2308,11,000,State - SIKKIM,Total,20-24,32151,2573,29578
C2308,11,000,State - SIKKIM,Total,25-29,29939,3820,26119
C2308,11,000,State - SIKKIM,Total,30-34,23663,4425,19238
C2308,11,000,State - SIKKIM,Total,35-39,20231,5589,14642
C2308,11,000,State - SIKKIM,Total,40-44,16382,6602,9780
C2308,11,000,State - SIKKIM,Total,45-49,13348,6963,6385
C2308,11,000,State - SIKKIM,Total,50-54,10808,6623,4185
C2308,11,000,State - SIKKIM,Total,55-59,7628,5285,2343
C2308,11,000,State - SIKKIM,Total,60-64,6109,4689,1420
C2308,11,000,State - SIKKIM,Total,65-69,4890,3837,1053
C2308,11,000,State - SIKKIM,Total,70-74,3257,2768,489
C2308,11,000,State - SIKKIM,Total,75-79,1960,1708,252
C2308,11,000,State - SIKKIM,Total,80+,2064,1704,360
C2308,11,000,State - SIKKIM,Total,Age not stated,539,156,383
C2308,11,000,State - SIKKIM,Rural,All ages,214202,76517,137685
C2308,11,000,State - SIKKIM,Rural,0-6,24157,24157,0
C2308,11,000,State - SIKKIM,Rural,7,4535,1023,3512
C2308,11,000,State - SIKKIM,Rural,8,4274,459,3815
C2308,11,000,State - SIKKIM,Rural,9,4699,458,4241
C2308,11,000,State - SIKKIM,Rural,10,5200,435,4765
C2308,11,000,State - SIKKIM,Rural,11,5054,253,4801
C2308,11,000,State - SIKKIM,Rural,12,5033,172,4861
C2308,11,000,State - SIKKIM,Rural,13,5092,153,4939
C2308,11,000,State - SIKKIM,Rural,14,5224,171,5053
C2308,11,000,State - SIKKIM,Rural,15,4994,212,4782
C2308,11,000,State - SIKKIM,Rural,16,5112,208,4904
C2308,11,000,State - SIKKIM,Rural,17,4782,200,4582
C2308,11,000,State - SIKKIM,Rural,18,5178,278,4900
C2308,11,000,State - SIKKIM,Rural,19,4750,271,4479
C2308,11,000,State - SIKKIM,Rural,20-24,23538,2035,21503
C2308,11,000,State - SIKKIM,Rural,25-29,21153,3094,18059
C2308,11,000,State - SIKKIM,Rural,30-34,16624,3612,13012
C2308,11,000,State - SIKKIM,Rural,35-39,14315,4662,9653
C2308,11,000,State - SIKKIM,Rural,40-44,11709,5663,6046
C2308,11,000,State - SIKKIM,Rural,45-49,9710,5956,3754
C2308,11,000,State - SIKKIM,Rural,50-54,8060,5756,2304
C2308,11,000,State - SIKKIM,Rural,55-59,5829,4542,1287
C2308,11,000,State - SIKKIM,Rural,60-64,4904,4061,843
C2308,11,000,State - SIKKIM,Rural,65-69,3948,3325,623
C2308,11,000,State - SIKKIM,Rural,70-74,2656,2367,289
C2308,11,000,State - SIKKIM,Rural,75-79,1586,1450,136
C2308,11,000,State - SIKKIM,Rural,80+,1630,1408,222
C2308,11,000,State - SIKKIM,Rural,Age not stated,456,136,320
C2308,11,000,State - SIKKIM,Urban,All ages,73305,17307,55998
C2308,11,000,State - SIKKIM,Urban,0-6,7193,7193,0
C2308,11,000,State - SIKKIM,Urban,7,1242,237,1005
C2308,11,000,State - SIKKIM,Urban,8,1223,89,1134
C2308,11,000,State - SIKKIM,Urban,9,1318,116,1202
C2308,11,000,State - SIKKIM,Urban,10,1414,123,1291
C2308,11,000,State - SIKKIM,Urban,11,1427,63,1364
C2308,11,000,State - SIKKIM,Urban,12,1521,66,1455
C2308,11,000,State - SIKKIM,Urban,13,1498,83,1415
C2308,11,000,State - SIKKIM,Urban,14,1495,94,1401
C2308,11,000,State - SIKKIM,Urban,15,1614,121,1493
C2308,11,000,State - SIKKIM,Urban,16,1649,119,1530
C2308,11,000,State - SIKKIM,Urban,17,1578,120,1458
C2308,11,000,State - SIKKIM,Urban,18,1729,120,1609
C2308,11,000,State - SIKKIM,Urban,19,1553,88,1465
C2308,11,000,State - SIKKIM,Urban,20-24,8613,538,8075
C2308,11,000,State - SIKKIM,Urban,25-29,8786,726,8060
C2308,11,000,State - SIKKIM,Urban,30-34,7039,813,6226
C2308,11,000,State - SIKKIM,Urban,35-39,5916,927,4989
C2308,11,000,State - SIKKIM,Urban,40-44,4673,939,3734
C2308,11,000,State - SIKKIM,Urban,45-49,3638,1007,2631
C2308,11,000,State - SIKKIM,Urban,50-54,2748,867,1881
C2308,11,000,State - SIKKIM,Urban,55-59,1799,743,1056
C2308,11,000,State - SIKKIM,Urban,60-64,1205,628,577
C2308,11,000,State - SIKKIM,Urban,65-69,942,512,430
C2308,11,000,State - SIKKIM,Urban,70-74,601,401,200
C2308,11,000,State - SIKKIM,Urban,75-79,374,258,116
C2308,11,000,State - SIKKIM,Urban,80+,434,296,138
C2308,11,000,State - SIKKIM,Urban,Age not stated,83,20,63
C2308,12,000,State - ARUNACHAL PRADESH,Total,All ages,669815,343678,326137
C2308,12,000,State - ARUNACHAL PRADESH,Total,0-6,104564,104564,0
C2308,12,000,State - ARUNACHAL PRADESH,Total,7,16935,7844,9091
C2308,12,000,State - ARUNACHAL PRADESH,Total,8,17750,6299,11451
C2308,12,000,State - ARUNACHAL PRADESH,Total,9,15590,4355,11235
C2308,12,000,State - ARUNACHAL PRADESH,Total,10,19292,4992,14300
C2308,12,000,State - ARUNACHAL PRADESH,Total,11,16425,3503,12922
C2308,12,000,State - ARUNACHAL PRADESH,Total,12,19202,3604,15598
C2308,12,000,State - ARUNACHAL PRADESH,Total,13,16612,2657,13955
C2308,12,000,State - ARUNACHAL PRADESH,Total,14,17389,2697,14692
C2308,12,000,State - ARUNACHAL PRADESH,Total,15,17639,2991,14648
C2308,12,000,State - ARUNACHAL PRADESH,Total,16,16267,2634,13633
C2308,12,000,State - ARUNACHAL PRADESH,Total,17,13679,2363,11316
C2308,12,000,State - ARUNACHAL PRADESH,Total,18,16749,3608,13141
C2308,12,000,State - ARUNACHAL PRADESH,Total,19,12961,3038,9923
C2308,12,000,State - ARUNACHAL PRADESH,Total,20-24,65663,19043,46620
C2308,12,000,State - ARUNACHAL PRADESH,Total,25-29,60348,23144,37204
C2308,12,000,State - ARUNACHAL PRADESH,Total,30-34,48709,22506,26203
C2308,12,000,State - ARUNACHAL PRADESH,Total,35-39,46180,25295,20885
C2308,12,000,State - ARUNACHAL PRADESH,Total,40-44,35742,22822,12920
C2308,12,000,State - ARUNACHAL PRADESH,Total,45-49,28506,20605,7901
C2308,12,000,State - ARUNACHAL PRADESH,Total,50-54,19623,15950,3673
C2308,12,000,State - ARUNACHAL PRADESH,Total,55-59,12890,11316,1574
C2308,12,000,State - ARUNACHAL PRADESH,Total,60-64,11953,10886,1067
C2308,12,000,State - ARUNACHAL PRADESH,Total,65-69,7331,6629,702
C2308,12,000,State - ARUNACHAL PRADESH,Total,70-74,5100,4749,351
C2308,12,000,State - ARUNACHAL PRADESH,Total,75-79,2448,2291,157
C2308,12,000,State - ARUNACHAL PRADESH,Total,80+,3618,2984,634
C2308,12,000,State - ARUNACHAL PRADESH,Total,Age not stated,650,309,341
C2308,12,000,State - ARUNACHAL PRADESH,Rural,All ages,520347,293835,226512
C2308,12,000,State - ARUNACHAL PRADESH,Rural,0-6,85048,85048,0
C2308,12,000,State - ARUNACHAL PRADESH,Rural,7,13490,6826,6664
C2308,12,000,State - ARUNACHAL PRADESH,Rural,8,14342,5596,8746
C2308,12,000,State - ARUNACHAL PRADESH,Rural,9,12411,3865,8546
C2308,12,000,State - ARUNACHAL PRADESH,Rural,10,15447,4410,11037
C2308,12,000,State - ARUNACHAL PRADESH,Rural,11,12776,3058,9718
C2308,12,000,State - ARUNACHAL PRADESH,Rural,12,15100,3178,11922
C2308,12,000,State - ARUNACHAL PRADESH,Rural,13,12597,2281,10316
C2308,12,000,State - ARUNACHAL PRADESH,Rural,14,13126,2263,10863
C2308,12,000,State - ARUNACHAL PRADESH,Rural,15,13222,2508,10714
C2308,12,000,State - ARUNACHAL PRADESH,Rural,16,11867,2193,9674
C2308,12,000,State - ARUNACHAL PRADESH,Rural,17,9813,1996,7817
C2308,12,000,State - ARUNACHAL PRADESH,Rural,18,12627,3110,9517
C2308,12,000,State - ARUNACHAL PRADESH,Rural,19,9574,2606,6968
C2308,12,000,State - ARUNACHAL PRADESH,Rural,20-24,48868,16531,32337
C2308,12,000,State - ARUNACHAL PRADESH,Rural,25-29,44957,20022,24935
C2308,12,000,State - ARUNACHAL PRADESH,Rural,30-34,36286,19335,16951
C2308,12,000,State - ARUNACHAL PRADESH,Rural,35-39,34322,21616,12706
C2308,12,000,State - ARUNACHAL PRADESH,Rural,40-44,27111,19665,7446
C2308,12,000,State - ARUNACHAL PRADESH,Rural,45-49,22316,17931,4385
C2308,12,000,State - ARUNACHAL PRADESH,Rural,50-54,16201,14129,2072
C2308,12,000,State - ARUNACHAL PRADESH,Rural,55-59,11158,10192,966
C2308,12,000,State - ARUNACHAL PRADESH,Rural,60-64,10603,9892,711
C2308,12,000,State - ARUNACHAL PRADESH,Rural,65-69,6591,6120,471
C2308,12,000,State - ARUNACHAL PRADESH,Rural,70-74,4599,4350,249
C2308,12,000,State - ARUNACHAL PRADESH,Rural,75-79,2220,2125,95
C2308,12,000,State - ARUNACHAL PRADESH,Rural,80+,3143,2726,417
C2308,12,000,State - ARUNACHAL PRADESH,Rural,Age not stated,532,263,269
C2308,12,000,State - ARUNACHAL PRADESH,Urban,All ages,149468,49843,99625
C2308,12,000,State - ARUNACHAL PRADESH,Urban,0-6,19516,19516,0
C2308,12,000,State - ARUNACHAL PRADESH,Urban,7,3445,1018,2427
C2308,12,000,State - ARUNACHAL PRADESH,Urban,8,3408,703,2705
C2308,12,000,State - ARUNACHAL PRADESH,Urban,9,3179,490,2689
C2308,12,000,State - ARUNACHAL PRADESH,Urban,10,3845,582,3263
C2308,12,000,State - ARUNACHAL PRADESH,Urban,11,3649,445,3204
C2308,12,000,State - ARUNACHAL PRADESH,Urban,12,4102,426,3676
C2308,12,000,State - ARUNACHAL PRADESH,Urban,13,4015,376,3639
C2308,12,000,State - ARUNACHAL PRADESH,Urban,14,4263,434,3829
C2308,12,000,State - ARUNACHAL PRADESH,Urban,15,4417,483,3934
C2308,12,000,State - ARUNACHAL PRADESH,Urban,16,4400,441,3959
C2308,12,000,State - ARUNACHAL PRADESH,Urban,17,3866,367,3499
C2308,12,000,State - ARUNACHAL PRADESH,Urban,18,4122,498,3624
C2308,12,000,State - ARUNACHAL PRADESH,Urban,19,3387,432,2955
C2308,12,000,State - ARUNACHAL PRADESH,Urban,20-24,16795,2512,14283
C2308,12,000,State - ARUNACHAL PRADESH,Urban,25-29,15391,3122,12269
C2308,12,000,State - ARUNACHAL PRADESH,Urban,30-34,12423,3171,9252
C2308,12,000,State - ARUNACHAL PRADESH,Urban,35-39,11858,3679,8179
C2308,12,000,State - ARUNACHAL PRADESH,Urban,40-44,8631,3157,5474
C2308,12,000,State - ARUNACHAL PRADESH,Urban,45-49,6190,2674,3516
C2308,12,000,State - ARUNACHAL PRADESH,Urban,50-54,3422,1821,1601
C2308,12,000,State - ARUNACHAL PRADESH,Urban,55-59,1732,1124,608
C2308,12,000,State - ARUNACHAL PRADESH,Urban,60-64,1350,994,356
C2308,12,000,State - ARUNACHAL PRADESH,Urban,65-69,740,509,231
C2308,12,000,State - ARUNACHAL PRADESH,Urban,70-74,501,399,102
C2308,12,000,State - ARUNACHAL PRADESH,Urban,75-79,228,166,62
C2308,12,000,State - ARUNACHAL PRADESH,Urban,80+,475,258,217
C2308,12,000,State - ARUNACHAL PRADESH,Urban,Age not stated,118,46,72
C2308,13,000,State - NAGALAND,Total,All ages,953853,335376,618477
C2308,13,000,State - NAGALAND,Total,0-6,141286,141286,0
C2308,13,000,State - NAGALAND,Total,7,22710,8944,13766
C2308,13,000,State - NAGALAND,Total,8,22453,5484,16969
C2308,13,000,State - NAGALAND,Total,9,21974,4551,17423
C2308,13,000,State - NAGALAND,Total,10,25995,4759,21236
C2308,13,000,State - NAGALAND,Total,11,23523,3202,20321
C2308,13,000,State - NAGALAND,Total,12,24375,2882,21493
C2308,13,000,State - NAGALAND,Total,13,22762,2370,20392
C2308,13,000,State - NAGALAND,Total,14,22779,2232,20547
C2308,13,000,State - NAGALAND,Total,15,24031,2679,21352
C2308,13,000,State - NAGALAND,Total,16,23480,2457,21023
C2308,13,000,State - NAGALAND,Total,17,21010,2181,18829
C2308,13,000,State - NAGALAND,Total,18,23908,2887,21021
C2308,13,000,State - NAGALAND,Total,19,19199,2378,16821
C2308,13,000,State - NAGALAND,Total,20-24,100594,14413,86181
C2308,13,000,State - NAGALAND,Total,25-29,87303,14981,72322
C2308,13,000,State - NAGALAND,Total,30-34,73419,14825,58594
C2308,13,000,State - NAGALAND,Total,35-39,63503,16299,47204
C2308,13,000,State - NAGALAND,Total,40-44,51608,16444,35164
C2308,13,000,State - NAGALAND,Total,45-49,39990,15181,24809
C2308,13,000,State - NAGALAND,Total,50-54,29725,13353,16372
C2308,13,000,State - NAGALAND,Total,55-59,19657,9931,9726
C2308,13,000,State - NAGALAND,Total,60-64,16836,9816,7020
C2308,13,000,State - NAGALAND,Total,65-69,11442,7131,4311
C2308,13,000,State - NAGALAND,Total,70-74,8333,5976,2357
C2308,13,000,State - NAGALAND,Total,75-79,4930,3649,1281
C2308,13,000,State - NAGALAND,Total,80+,6406,4847,1559
C2308,13,000,State - NAGALAND,Total,Age not stated,622,238,384
C2308,13,000,State - NAGALAND,Rural,All ages,682064,269422,412642
C2308,13,000,State - NAGALAND,Rural,0-6,104999,104999,0
C2308,13,000,State - NAGALAND,Rural,7,16788,7381,9407
C2308,13,000,State - NAGALAND,Rural,8,16766,4718,12048
C2308,13,000,State - NAGALAND,Rural,9,16231,3907,12324
C2308,13,000,State - NAGALAND,Rural,10,19272,4072,15200
C2308,13,000,State - NAGALAND,Rural,11,17057,2747,14310
C2308,13,000,State - NAGALAND,Rural,12,17855,2503,15352
C2308,13,000,State - NAGALAND,Rural,13,16207,2026,14181
C2308,13,000,State - NAGALAND,Rural,14,16100,1892,14208
C2308,13,000,State - NAGALAND,Rural,15,17258,2292,14966
C2308,13,000,State - NAGALAND,Rural,16,16668,2110,14558
C2308,13,000,State - NAGALAND,Rural,17,14462,1865,12597
C2308,13,000,State - NAGALAND,Rural,18,17000,2481,14519
C2308,13,000,State - NAGALAND,Rural,19,13179,2017,11162
C2308,13,000,State - NAGALAND,Rural,20-24,68637,12125,56512
C2308,13,000,State - NAGALAND,Rural,25-29,58543,12344,46199
C2308,13,000,State - NAGALAND,Rural,30-34,49710,12208,37502
C2308,13,000,State - NAGALAND,Rural,35-39,44103,13472,30631
C2308,13,000,State - NAGALAND,Rural,40-44,36818,13841,22977
C2308,13,000,State - NAGALAND,Rural,45-49,28701,12862,15839
C2308,13,000,State - NAGALAND,Rural,50-54,22142,11550,10592
C2308,13,000,State - NAGALAND,Rural,55-59,14853,8600,6253
C2308,13,000,State - NAGALAND,Rural,60-64,13303,8595,4708
C2308,13,000,State - NAGALAND,Rural,65-69,9009,6189,2820
C2308,13,000,State - NAGALAND,Rural,70-74,6803,5240,1563
C2308,13,000,State - NAGALAND,Rural,75-79,4023,3156,867
C2308,13,000,State - NAGALAND,Rural,80+,5035,4013,1022
C2308,13,000,State - NAGALAND,Rural,Age not stated,542,217,325
C2308,13,000,State - NAGALAND,Urban,All ages,271789,65954,205835
C2308,13,000,State - NAGALAND,Urban,0-6,36287,36287,0
C2308,13,000,State - NAGALAND,Urban,7,5922,1563,4359
C2308,13,000,State - NAGALAND,Urban,8,5687,766,4921
C2308,13,000,State - NAGALAND,Urban,9,5743,644,5099
C2308,13,000,State - NAGALAND,Urban,10,6723,687,6036
C2308,13,000,State - NAGALAND,Urban,11,6466,455,6011
C2308,13,000,State - NAGALAND,Urban,12,6520,379,6141
C2308,13,000,State - NAGALAND,Urban,13,6555,344,6211
C2308,13,000,State - NAGALAND,Urban,14,6679,340,6339
C2308,13,000,State - NAGALAND,Urban,15,6773,387,6386
C2308,13,000,State - NAGALAND,Urban,16,6812,347,6465
C2308,13,000,State - NAGALAND,Urban,17,6548,316,6232
C2308,13,000,State - NAGALAND,Urban,18,6908,406,6502
C2308,13,000,State - NAGALAND,Urban,19,6020,361,5659
C2308,13,000,State - NAGALAND,Urban,20-24,31957,2288,29669
C2308,13,000,State - NAGALAND,Urban,25-29,28760,2637,26123
C2308,13,000,State - NAGALAND,Urban,30-34,23709,2617,21092
C2308,13,000,State - NAGALAND,Urban,35-39,19400,2827,16573
C2308,13,000,State - NAGALAND,Urban,40-44,14790,2603,12187
C2308,13,000,State - NAGALAND,Urban,45-49,11289,2319,8970
C2308,13,000,State - NAGALAND,Urban,50-54,7583,1803,5780
C2308,13,000,State - NAGALAND,Urban,55-59,4804,1331,3473
C2308,13,000,State - NAGALAND,Urban,60-64,3533,1221,2312
C2308,13,000,State - NAGALAND,Urban,65-69,2433,942,1491
C2308,13,000,State - NAGALAND,Urban,70-74,1530,736,794
C2308,13,000,State - NAGALAND,Urban,75-79,907,493,414
C2308,13,000,State - NAGALAND,Urban,80+,1371,834,537
C2308,13,000,State - NAGALAND,Urban,Age not stated,80,21,59
C2308,14,000,State - MANIPUR,Total,All ages,1417208,548590,868618
C2308,14,000,State - MANIPUR,Total,0-6,180873,180873,0
C2308,14,000,State - MANIPUR,Total,7,29182,11071,18111
C2308,14,000,State - MANIPUR,Total,8,28941,7804,21137
C2308,14,000,State - MANIPUR,Total,9,26003,5614,20389
C2308,14,000,State - MANIPUR,Total,10,32579,6163,26416
C2308,14,000,State - MANIPUR,Total,11,28749,4111,24638
C2308,14,000,State - MANIPUR,Total,12,31539,3959,27580
C2308,14,000,State - MANIPUR,Total,13,29713,3045,26668
C2308,14,000,State - MANIPUR,Total,14,30037,3030,27007
C2308,14,000,State - MANIPUR,Total,15,30768,3194,27574
C2308,14,000,State - MANIPUR,Total,16,28031,3101,24930
C2308,14,000,State - MANIPUR,Total,17,26137,3035,23102
C2308,14,000,State - MANIPUR,Total,18,32291,4548,27743
C2308,14,000,State - MANIPUR,Total,19,25286,3603,21683
C2308,14,000,State - MANIPUR,Total,20-24,142195,23726,118469
C2308,14,000,State - MANIPUR,Total,25-29,137589,28017,109572
C2308,14,000,State - MANIPUR,Total,30-34,111276,26461,84815
C2308,14,000,State - MANIPUR,Total,35-39,100434,30413,70021
C2308,14,000,State - MANIPUR,Total,40-44,84933,32073,52860
C2308,14,000,State - MANIPUR,Total,45-49,73113,32913,40200
C2308,14,000,State - MANIPUR,Total,50-54,59679,30442,29237
C2308,14,000,State - MANIPUR,Total,55-59,44090,25242,18848
C2308,14,000,State - MANIPUR,Total,60-64,35330,23297,12033
C2308,14,000,State - MANIPUR,Total,65-69,23430,17344,6086
C2308,14,000,State - MANIPUR,Total,70-74,17477,14220,3257
C2308,14,000,State - MANIPUR,Total,75-79,10765,9070,1695
C2308,14,000,State - MANIPUR,Total,80+,13223,10952,2271
C2308,14,000,State - MANIPUR,Total,Age not stated,3545,1269,2276
C2308,14,000,State - MANIPUR,Rural,All ages,994756,422031,572725
C2308,14,000,State - MANIPUR,Rural,0-6,131503,131503,0
C2308,14,000,State - MANIPUR,Rural,7,21490,8836,12654
C2308,14,000,State - MANIPUR,Rural,8,21425,6417,15008
C2308,14,000,State - MANIPUR,Rural,9,19201,4666,14535
C2308,14,000,State - MANIPUR,Rural,10,24212,5168,19044
C2308,14,000,State - MANIPUR,Rural,11,20981,3465,17516
C2308,14,000,State - MANIPUR,Rural,12,23110,3403,19707
C2308,14,000,State - MANIPUR,Rural,13,21460,2626,18834
C2308,14,000,State - MANIPUR,Rural,14,21865,2648,19217
C2308,14,000,State - MANIPUR,Rural,15,22553,2746,19807
C2308,14,000,State - MANIPUR,Rural,16,20781,2737,18044
C2308,14,000,State - MANIPUR,Rural,17,19129,2658,16471
C2308,14,000,State - MANIPUR,Rural,18,24038,3919,20119
C2308,14,000,State - MANIPUR,Rural,19,18632,3205,15427
C2308,14,000,State - MANIPUR,Rural,20-24,102516,20687,81829
C2308,14,000,State - MANIPUR,Rural,25-29,95261,23803,71458
C2308,14,000,State - MANIPUR,Rural,30-34,75779,22110,53669
C2308,14,000,State - MANIPUR,Rural,35-39,67986,24898,43088
C2308,14,000,State - MANIPUR,Rural,40-44,57665,25954,31711
C2308,14,000,State - MANIPUR,Rural,45-49,49541,26095,23446
C2308,14,000,State - MANIPUR,Rural,50-54,39480,23414,16066
C2308,14,000,State - MANIPUR,Rural,55-59,29046,19046,10000
C2308,14,000,State - MANIPUR,Rural,60-64,23348,16938,6410
C2308,14,000,State - MANIPUR,Rural,65-69,15329,12076,3253
C2308,14,000,State - MANIPUR,Rural,70-74,11287,9563,1724
C2308,14,000,State - MANIPUR,Rural,75-79,6695,5820,875
C2308,14,000,State - MANIPUR,Rural,80+,7934,6641,1293
C2308,14,000,State - MANIPUR,Rural,Age not stated,2509,989,1520
C2308,14,000,State - MANIPUR,Urban,All ages,422452,126559,295893
C2308,14,000,State - MANIPUR,Urban,0-6,49370,49370,0
C2308,14,000,State - MANIPUR,Urban,7,7692,2235,5457
C2308,14,000,State - MANIPUR,Urban,8,7516,1387,6129
C2308,14,000,State - MANIPUR,Urban,9,6802,948,5854
C2308,14,000,State - MANIPUR,Urban,10,8367,995,7372
C2308,14,000,State - MANIPUR,Urban,11,7768,646,7122
C2308,14,000,State - MANIPUR,Urban,12,8429,556,7873
C2308,14,000,State - MANIPUR,Urban,13,8253,419,7834
C2308,14,000,State - MANIPUR,Urban,14,8172,382,7790
C2308,14,000,State - MANIPUR,Urban,15,8215,448,7767
C2308,14,000,State - MANIPUR,Urban,16,7250,364,6886
C2308,14,000,State - MANIPUR,Urban,17,7008,377,6631
C2308,14,000,State - MANIPUR,Urban,18,8253,629,7624
C2308,14,000,State - MANIPUR,Urban,19,6654,398,6256
C2308,14,000,State - MANIPUR,Urban,20-24,39679,3039,36640
C2308,14,000,State - MANIPUR,Urban,25-29,42328,4214,38114
C2308,14,000,State - MANIPUR,Urban,30-34,35497,4351,31146
C2308,14,000,State - MANIPUR,Urban,35-39,32448,5515,26933
C2308,14,000,State - MANIPUR,Urban,40-44,27268,6119,21149
C2308,14,000,State - MANIPUR,Urban,45-49,23572,6818,16754
C2308,14,000,State - MANIPUR,Urban,50-54,20199,7028,13171
C2308,14,000,State - MANIPUR,Urban,55-59,15044,6196,8848
C2308,14,000,State - MANIPUR,Urban,60-64,11982,6359,5623
C2308,14,000,State - MANIPUR,Urban,65-69,8101,5268,2833
C2308,14,000,State - MANIPUR,Urban,70-74,6190,4657,1533
C2308,14,000,State - MANIPUR,Urban,75-79,4070,3250,820
C2308,14,000,State - MANIPUR,Urban,80+,5289,4311,978
C2308,14,000,State - MANIPUR,Urban,Age not stated,1036,280,756
C2308,15,000,State - MIZORAM,Total,All ages,541867,132221,409646
C2308,15,000,State - MIZORAM,Total,0-6,82970,82970,0
C2308,15,000,State - MIZORAM,Total,7,11967,2576,9391
C2308,15,000,State - MIZORAM,Total,8,11484,1378,10106
C2308,15,000,State - MIZORAM,Total,9,11171,941,10230
C2308,15,000,State - MIZORAM,Total,10,12511,1109,11402
C2308,15,000,State - MIZORAM,Total,11,11432,773,10659
C2308,15,000,State - MIZORAM,Total,12,11285,680,10605
C2308,15,000,State - MIZORAM,Total,13,11099,603,10496
C2308,15,000,State - MIZORAM,Total,14,11128,599,10529
C2308,15,000,State - MIZORAM,Total,15,10928,670,10258
C2308,15,000,State - MIZORAM,Total,16,10929,613,10316
C2308,15,000,State - MIZORAM,Total,17,10601,644,9957
C2308,15,000,State - MIZORAM,Total,18,11304,894,10410
C2308,15,000,State - MIZORAM,Total,19,10674,979,9695
C2308,15,000,State - MIZORAM,Total,20-24,56196,5425,50771
C2308,15,000,State - MIZORAM,Total,25-29,50956,4834,46122
C2308,15,000,State - MIZORAM,Total,30-34,44033,3831,40202
C2308,15,000,State - MIZORAM,Total,35-39,35567,3508,32059
C2308,15,000,State - MIZORAM,Total,40-44,28210,3388,24822
C2308,15,000,State - MIZORAM,Total,45-49,26147,3094,23053
C2308,15,000,State - MIZORAM,Total,50-54,21700,2997,18703
C2308,15,000,State - MIZORAM,Total,55-59,15038,2150,12888
C2308,15,000,State - MIZORAM,Total,60-64,12123,1965,10158
C2308,15,000,State - MIZORAM,Total,65-69,8056,1529,6527
C2308,15,000,State - MIZORAM,Total,70-74,5912,1401,4511
C2308,15,000,State - MIZORAM,Total,75-79,3900,1109,2791
C2308,15,000,State - MIZORAM,Total,80+,4292,1513,2779
C2308,15,000,State - MIZORAM,Total,Age not stated,254,48,206
C2308,15,000,State - MIZORAM,Rural,All ages,256300,88366,167934
C2308,15,000,State - MIZORAM,Rural,0-6,45895,45895,0
C2308,15,000,State - MIZORAM,Rural,7,6634,1960,4674
C2308,15,000,State - MIZORAM,Rural,8,6298,1197,5101
C2308,15,000,State - MIZORAM,Rural,9,5891,841,5050
C2308,15,000,State - MIZORAM,Rural,10,6634,949,5685
C2308,15,000,State - MIZORAM,Rural,11,5813,709,5104
C2308,15,000,State - MIZORAM,Rural,12,5864,645,5219
C2308,15,000,State - MIZORAM,Rural,13,5598,564,5034
C2308,15,000,State - MIZORAM,Rural,14,5343,556,4787
C2308,15,000,State - MIZORAM,Rural,15,5071,618,4453
C2308,15,000,State - MIZORAM,Rural,16,4920,559,4361
C2308,15,000,State - MIZORAM,Rural,17,4582,582,4000
C2308,15,000,State - MIZORAM,Rural,18,4905,835,4070
C2308,15,000,State - MIZORAM,Rural,19,4779,932,3847
C2308,15,000,State - MIZORAM,Rural,20-24,25655,5081,20574
C2308,15,000,State - MIZORAM,Rural,25-29,22942,4465,18477
C2308,15,000,State - MIZORAM,Rural,30-34,18939,3480,15459
C2308,15,000,State - MIZORAM,Rural,35-39,15168,3146,12022
C2308,15,000,State - MIZORAM,Rural,40-44,11893,2984,8909
C2308,15,000,State - MIZORAM,Rural,45-49,11062,2641,8421
C2308,15,000,State - MIZORAM,Rural,50-54,9720,2544,7176
C2308,15,000,State - MIZORAM,Rural,55-59,6833,1748,5085
C2308,15,000,State - MIZORAM,Rural,60-64,5626,1590,4036
C2308,15,000,State - MIZORAM,Rural,65-69,3773,1184,2589
C2308,15,000,State - MIZORAM,Rural,70-74,2665,982,1683
C2308,15,000,State - MIZORAM,Rural,75-79,1723,709,1014
C2308,15,000,State - MIZORAM,Rural,80+,1948,938,1010
C2308,15,000,State - MIZORAM,Rural,Age not stated,126,32,94
C2308,15,000,State - MIZORAM,Urban,All ages,285567,43855,241712
C2308,15,000,State - MIZORAM,Urban,0-6,37075,37075,0
C2308,15,000,State - MIZORAM,Urban,7,5333,616,4717
C2308,15,000,State - MIZORAM,Urban,8,5186,181,5005
C2308,15,000,State - MIZORAM,Urban,9,5280,100,5180
C2308,15,000,State - MIZORAM,Urban,10,5877,160,5717
C2308,15,000,State - MIZORAM,Urban,11,5619,64,5555
C2308,15,000,State - MIZORAM,Urban,12,5421,35,5386
C2308,15,000,State - MIZORAM,Urban,13,5501,39,5462
C2308,15,000,State - MIZORAM,Urban,14,5785,43,5742
C2308,15,000,State - MIZORAM,Urban,15,5857,52,5805
C2308,15,000,State - MIZORAM,Urban,16,6009,54,5955
C2308,15,000,State - MIZORAM,Urban,17,6019,62,5957
C2308,15,000,State - MIZORAM,Urban,18,6399,59,6340
C2308,15,000,State - MIZORAM,Urban,19,5895,47,5848
C2308,15,000,State - MIZORAM,Urban,20-24,30541,344,30197
C2308,15,000,State - MIZORAM,Urban,25-29,28014,369,27645
C2308,15,000,State - MIZORAM,Urban,30-34,25094,351,24743
C2308,15,000,State - MIZORAM,Urban,35-39,20399,362,20037
C2308,15,000,State - MIZORAM,Urban,40-44,16317,404,15913
C2308,15,000,State - MIZORAM,Urban,45-49,15085,453,14632
C2308,15,000,State - MIZORAM,Urban,50-54,11980,453,11527
C2308,15,000,State - MIZORAM,Urban,55-59,8205,402,7803
C2308,15,000,State - MIZORAM,Urban,60-64,6497,375,6122
C2308,15,000,State - MIZORAM,Urban,65-69,4283,345,3938
C2308,15,000,State - MIZORAM,Urban,70-74,3247,419,2828
C2308,15,000,State - MIZORAM,Urban,75-79,2177,400,1777
C2308,15,000,State - MIZORAM,Urban,80+,2344,575,1769
C2308,15,000,State - MIZORAM,Urban,Age not stated,128,16,112
C2308,16,000,State - TRIPURA,Total,All ages,1799541,496127,1303414
C2308,16,000,State - TRIPURA,Total,0-6,224006,224006,0
C2308,16,000,State - TRIPURA,Total,7,32512,5925,26587
C2308,16,000,State - TRIPURA,Total,8,33481,2425,31056
C2308,16,000,State - TRIPURA,Total,9,33256,1680,31576
C2308,16,000,State - TRIPURA,Total,10,36202,2035,34167
C2308,16,000,State - TRIPURA,Total,11,34324,1294,33030
C2308,16,000,State - TRIPURA,Total,12,36189,1415,34774
C2308,16,000,State - TRIPURA,Total,13,33999,1137,32862
C2308,16,000,State - TRIPURA,Total,14,33975,1302,32673
C2308,16,000,State - TRIPURA,Total,15,34722,1795,32927
C2308,16,000,State - TRIPURA,Total,16,34633,1815,32818
C2308,16,000,State - TRIPURA,Total,17,31846,1801,30045
C2308,16,000,State - TRIPURA,Total,18,38971,3105,35866
C2308,16,000,State - TRIPURA,Total,19,36521,2685,33836
C2308,16,000,State - TRIPURA,Total,20-24,189398,16445,172953
C2308,16,000,State - TRIPURA,Total,25-29,169090,18672,150418
C2308,16,000,State - TRIPURA,Total,30-34,137758,17487,120271
C2308,16,000,State - TRIPURA,Total,35-39,136291,22687,113604
C2308,16,000,State - TRIPURA,Total,40-44,114658,24843,89815
C2308,16,000,State - TRIPURA,Total,45-49,98752,25393,73359
C2308,16,000,State - TRIPURA,Total,50-54,75559,22320,53239
C2308,16,000,State - TRIPURA,Total,55-59,55025,18978,36047
C2308,16,000,State - TRIPURA,Total,60-64,47518,20709,26809
C2308,16,000,State - TRIPURA,Total,65-69,35436,17560,17876
C2308,16,000,State - TRIPURA,Total,70-74,26789,15019,11770
C2308,16,000,State - TRIPURA,Total,75-79,15827,9291,6536
C2308,16,000,State - TRIPURA,Total,80+,22054,14090,7964
C2308,16,000,State - TRIPURA,Total,Age not stated,749,213,536
C2308,16,000,State - TRIPURA,Rural,All ages,1325291,414021,911270
C2308,16,000,State - TRIPURA,Rural,0-6,178909,178909,0
C2308,16,000,State - TRIPURA,Rural,7,25565,5078,20487
C2308,16,000,State - TRIPURA,Rural,8,26379,2211,24168
C2308,16,000,State - TRIPURA,Rural,9,26164,1532,24632
C2308,16,000,State - TRIPURA,Rural,10,28822,1828,26994
C2308,16,000,State - TRIPURA,Rural,11,26942,1166,25776
C2308,16,000,State - TRIPURA,Rural,12,28881,1305,27576
C2308,16,000,State - TRIPURA,Rural,13,26834,1053,25781
C2308,16,000,State - TRIPURA,Rural,14,26611,1185,25426
C2308,16,000,State - TRIPURA,Rural,15,27167,1643,25524
C2308,16,000,State - TRIPURA,Rural,16,26679,1650,25029
C2308,16,000,State - TRIPURA,Rural,17,23979,1628,22351
C2308,16,000,State - TRIPURA,Rural,18,30143,2833,27310
C2308,16,000,State - TRIPURA,Rural,19,27543,2453,25090
C2308,16,000,State - TRIPURA,Rural,20-24,142410,14966,127444
C2308,16,000,State - TRIPURA,Rural,25-29,123471,16881,106590
C2308,16,000,State - TRIPURA,Rural,30-34,97137,15630,81507
C2308,16,000,State - TRIPURA,Rural,35-39,94471,19898,74573
C2308,16,000,State - TRIPURA,Rural,40-44,78462,21508,56954
C2308,16,000,State - TRIPURA,Rural,45-49,66634,21880,44754
C2308,16,000,State - TRIPURA,Rural,50-54,50320,19036,31284
C2308,16,000,State - TRIPURA,Rural,55-59,36881,16238,20643
C2308,16,000,State - TRIPURA,Rural,60-64,33355,17514,15841
C2308,16,000,State - TRIPURA,Rural,65-69,25359,14768,10591
C2308,16,000,State - TRIPURA,Rural,70-74,19066,12325,6741
C2308,16,000,State - TRIPURA,Rural,75-79,10907,7449,3458
C2308,16,000,State - TRIPURA,Rural,80+,15733,11296,4437
C2308,16,000,State - TRIPURA,Rural,Age not stated,467,158,309
C2308,16,000,State - TRIPURA,Urban,All ages,474250,82106,392144
C2308,16,000,State - TRIPURA,Urban,0-6,45097,45097,0
C2308,16,000,State - TRIPURA,Urban,7,6947,847,6100
C2308,16,000,State - TRIPURA,Urban,8,7102,214,6888
C2308,16,000,State - TRIPURA,Urban,9,7092,148,6944
C2308,16,000,State - TRIPURA,Urban,10,7380,207,7173
C2308,16,000,State - TRIPURA,Urban,11,7382,128,7254
C2308,16,000,State - TRIPURA,Urban,12,7308,110,7198
C2308,16,000,State - TRIPURA,Urban,13,7165,84,7081
C2308,16,000,State - TRIPURA,Urban,14,7364,117,7247
C2308,16,000,State - TRIPURA,Urban,15,7555,152,7403
C2308,16,000,State - TRIPURA,Urban,16,7954,165,7789
C2308,16,000,State - TRIPURA,Urban,17,7867,173,7694
C2308,16,000,State - TRIPURA,Urban,18,8828,272,8556
C2308,16,000,State - TRIPURA,Urban,19,8978,232,8746
C2308,16,000,State - TRIPURA,Urban,20-24,46988,1479,45509
C2308,16,000,State - TRIPURA,Urban,25-29,45619,1791,43828
C2308,16,000,State - TRIPURA,Urban,30-34,40621,1857,38764
C2308,16,000,State - TRIPURA,Urban,35-39,41820,2789,39031
C2308,16,000,State - TRIPURA,Urban,40-44,36196,3335,32861
C2308,16,000,State - TRIPURA,Urban,45-49,32118,3513,28605
C2308,16,000,State - TRIPURA,Urban,50-54,25239,3284,21955
C2308,16,000,State - TRIPURA,Urban,55-59,18144,2740,15404
C2308,16,000,State - TRIPURA,Urban,60-64,14163,3195,10968
C2308,16,000,State - TRIPURA,Urban,65-69,10077,2792,7285
C2308,16,000,State - TRIPURA,Urban,70-74,7723,2694,5029
C2308,16,000,State - TRIPURA,Urban,75-79,4920,1842,3078
C2308,16,000,State - TRIPURA,Urban,80+,6321,2794,3527
C2308,16,000,State - TRIPURA,Urban,Age not stated,282,55,227
C2308,17,000,State - MEGHALAYA,Total,All ages,1475057,603931,871126
C2308,17,000,State - MEGHALAYA,Total,0-6,279890,279890,0
C2308,17,000,State - MEGHALAYA,Total,7,38367,16873,21494
C2308,17,000,State - MEGHALAYA,Total,8,37883,10690,27193
C2308,17,000,State - MEGHALAYA,Total,9,35765,7771,27994
C2308,17,000,State - MEGHALAYA,Total,10,41393,7654,33739
C2308,17,000,State - MEGHALAYA,Total,11,37563,4996,32567
C2308,17,000,State - MEGHALAYA,Total,12,38291,4051,34240
C2308,17,000,State - MEGHALAYA,Total,13,36034,3326,32708
C2308,17,000,State - MEGHALAYA,Total,14,35852,3173,32679
C2308,17,000,State - MEGHALAYA,Total,15,34808,3328,31480
C2308,17,000,State - MEGHALAYA,Total,16,34117,3288,30829
C2308,17,000,State - MEGHALAYA,Total,17,30561,3271,27290
C2308,17,000,State - MEGHALAYA,Total,18,33240,4321,28919
C2308,17,000,State - MEGHALAYA,Total,19,28746,4265,24481
C2308,17,000,State - MEGHALAYA,Total,20-24,145872,26140,119732
C2308,17,000,State - MEGHALAYA,Total,25-29,126605,29634,96971
C2308,17,000,State - MEGHALAYA,Total,30-34,93871,25506,68365
C2308,17,000,State - MEGHALAYA,Total,35-39,87386,29442,57944
C2308,17,000,State - MEGHALAYA,Total,40-44,72073,28233,43840
C2308,17,000,State - MEGHALAYA,Total,45-49,60072,27034,33038
C2308,17,000,State - MEGHALAYA,Total,50-54,42833,20518,22315
C2308,17,000,State - MEGHALAYA,Total,55-59,29417,15295,14122
C2308,17,000,State - MEGHALAYA,Total,60-64,25287,14388,10899
C2308,17,000,State - MEGHALAYA,Total,65-69,18292,11109,7183
C2308,17,000,State - MEGHALAYA,Total,70-74,12537,8279,4258
C2308,17,000,State - MEGHALAYA,Total,75-79,6997,4685,2312
C2308,17,000,State - MEGHALAYA,Total,80+,8850,5781,3069
C2308,17,000,State - MEGHALAYA,Total,Age not stated,2455,990,1465
C2308,17,000,State - MEGHALAYA,Rural,All ages,1177179,537661,639518
C2308,17,000,State - MEGHALAYA,Rural,0-6,241841,241841,0
C2308,17,000,State - MEGHALAYA,Rural,7,32742,15611,17131
C2308,17,000,State - MEGHALAYA,Rural,8,32252,10219,22033
C2308,17,000,State - MEGHALAYA,Rural,9,30208,7416,22792
C2308,17,000,State - MEGHALAYA,Rural,10,34804,7273,27531
C2308,17,000,State - MEGHALAYA,Rural,11,31102,4766,26336
C2308,17,000,State - MEGHALAYA,Rural,12,31606,3861,27745
C2308,17,000,State - MEGHALAYA,Rural,13,29391,3152,26239
C2308,17,000,State - MEGHALAYA,Rural,14,28673,2971,25702
C2308,17,000,State - MEGHALAYA,Rural,15,27368,3075,24293
C2308,17,000,State - MEGHALAYA,Rural,16,26424,3042,23382
C2308,17,000,State - MEGHALAYA,Rural,17,23396,3045,20351
C2308,17,000,State - MEGHALAYA,Rural,18,25670,4008,21662
C2308,17,000,State - MEGHALAYA,Rural,19,22136,3972,18164
C2308,17,000,State - MEGHALAYA,Rural,20-24,112271,24319,87952
C2308,17,000,State - MEGHALAYA,Rural,25-29,96886,27389,69497
C2308,17,000,State - MEGHALAYA,Rural,30-34,70728,23270,47458
C2308,17,000,State - MEGHALAYA,Rural,35-39,66164,26721,39443
C2308,17,000,State - MEGHALAYA,Rural,40-44,54959,25657,29302
C2308,17,000,State - MEGHALAYA,Rural,45-49,46129,24485,21644
C2308,17,000,State - MEGHALAYA,Rural,50-54,32313,18348,13965
C2308,17,000,State - MEGHALAYA,Rural,55-59,22308,13658,8650
C2308,17,000,State - MEGHALAYA,Rural,60-64,19673,12840,6833
C2308,17,000,State - MEGHALAYA,Rural,65-69,14468,9848,4620
C2308,17,000,State - MEGHALAYA,Rural,70-74,9718,7196,2522
C2308,17,000,State - MEGHALAYA,Rural,75-79,5211,3950,1261
C2308,17,000,State - MEGHALAYA,Rural,80+,6558,4809,1749
C2308,17,000,State - MEGHALAYA,Rural,Age not stated,2180,919,1261
C2308,17,000,State - MEGHALAYA,Urban,All ages,297878,66270,231608
C2308,17,000,State - MEGHALAYA,Urban,0-6,38049,38049,0
C2308,17,000,State - MEGHALAYA,Urban,7,5625,1262,4363
C2308,17,000,State - MEGHALAYA,Urban,8,5631,471,5160
C2308,17,000,State - MEGHALAYA,Urban,9,5557,355,5202
C2308,17,000,State - MEGHALAYA,Urban,10,6589,381,6208
C2308,17,000,State - MEGHALAYA,Urban,11,6461,230,6231
C2308,17,000,State - MEGHALAYA,Urban,12,6685,190,6495
C2308,17,000,State - MEGHALAYA,Urban,13,6643,174,6469
C2308,17,000,State - MEGHALAYA,Urban,14,7179,202,6977
C2308,17,000,State - MEGHALAYA,Urban,15,7440,253,7187
C2308,17,000,State - MEGHALAYA,Urban,16,7693,246,7447
C2308,17,000,State - MEGHALAYA,Urban,17,7165,226,6939
C2308,17,000,State - MEGHALAYA,Urban,18,7570,313,7257
C2308,17,000,State - MEGHALAYA,Urban,19,6610,293,6317
C2308,17,000,State - MEGHALAYA,Urban,20-24,33601,1821,31780
C2308,17,000,State - MEGHALAYA,Urban,25-29,29719,2245,27474
C2308,17,000,State - MEGHALAYA,Urban,30-34,23143,2236,20907
C2308,17,000,State - MEGHALAYA,Urban,35-39,21222,2721,18501
C2308,17,000,State - MEGHALAYA,Urban,40-44,17114,2576,14538
C2308,17,000,State - MEGHALAYA,Urban,45-49,13943,2549,11394
C2308,17,000,State - MEGHALAYA,Urban,50-54,10520,2170,8350
C2308,17,000,State - MEGHALAYA,Urban,55-59,7109,1637,5472
C2308,17,000,State - MEGHALAYA,Urban,60-64,5614,1548,4066
C2308,17,000,State - MEGHALAYA,Urban,65-69,3824,1261,2563
C2308,17,000,State - MEGHALAYA,Urban,70-74,2819,1083,1736
C2308,17,000,State - MEGHALAYA,Urban,75-79,1786,735,1051
C2308,17,000,State - MEGHALAYA,Urban,80+,2292,972,1320
C2308,17,000,State - MEGHALAYA,Urban,Age not stated,275,71,204
C2308,18,000,State - ASSAM,Total,All ages,15266133,6656795,8609338
C2308,18,000,State - ASSAM,Total,0-6,2274645,2274645,0
C2308,18,000,State - ASSAM,Total,7,362567,112760,249807
C2308,18,000,State - ASSAM,Total,8,360231,72686,287545
C2308,18,000,State - ASSAM,Total,9,318461,48247,270214
C2308,18,000,State - ASSAM,Total,10,370837,54953,315884
C2308,18,000,State - ASSAM,Total,11,318029,36478,281551
C2308,18,000,State - ASSAM,Total,12,361395,41841,319554
C2308,18,000,State - ASSAM,Total,13,326074,34972,291102
C2308,18,000,State - ASSAM,Total,14,326011,36222,289789
C2308,18,000,State - ASSAM,Total,15,321086,41179,279907
C2308,18,000,State - ASSAM,Total,16,293515,39701,253814
C2308,18,000,State - ASSAM,Total,17,244018,34354,209664
C2308,18,000,State - ASSAM,Total,18,332016,64290,267726
C2308,18,000,State - ASSAM,Total,19,282457,55926,226531
C2308,18,000,State - ASSAM,Total,20-24,1493825,370758,1123067
C2308,18,000,State - ASSAM,Total,25-29,1422105,436582,985523
C2308,18,000,State - ASSAM,Total,30-34,1155813,404711,751102
C2308,18,000,State - ASSAM,Total,35-39,1106794,452091,654703
C2308,18,000,State - ASSAM,Total,40-44,865743,409531,456212
C2308,18,000,State - ASSAM,Total,45-49,749168,383804,365364
C2308,18,000,State - ASSAM,Total,50-54,550103,306858,243245
C2308,18,000,State - ASSAM,Total,55-59,398583,231980,166603
C2308,18,000,State - ASSAM,Total,60-64,381135,248318,132817
C2308,18,000,State - ASSAM,Total,65-69,249669,167648,82021
C2308,18,000,State - ASSAM,Total,70-74,188832,140393,48439
C2308,18,000,State - ASSAM,Total,75-79,87753,64146,23607
C2308,18,000,State - ASSAM,Total,80+,116338,87693,28645
C2308,18,000,State - ASSAM,Total,Age not stated,8930,4028,4902
C2308,18,000,State - ASSAM,Rural,All ages,13128045,6148802,6979243
C2308,18,000,State - ASSAM,Rural,0-6,2055737,2055737,0
C2308,18,000,State - ASSAM,Rural,7,326458,106477,219981
C2308,18,000,State - ASSAM,Rural,8,325265,69838,255427
C2308,18,000,State - ASSAM,Rural,9,284817,46135,238682
C2308,18,000,State - ASSAM,Rural,10,332108,52308,279800
C2308,18,000,State - ASSAM,Rural,11,281345,34684,246661
C2308,18,000,State - ASSAM,Rural,12,322447,39933,282514
C2308,18,000,State - ASSAM,Rural,13,288764,33251,255513
C2308,18,000,State - ASSAM,Rural,14,287338,34214,253124
C2308,18,000,State - ASSAM,Rural,15,282055,38889,243166
C2308,18,000,State - ASSAM,Rural,16,255417,37469,217948
C2308,18,000,State - ASSAM,Rural,17,207787,32333,175454
C2308,18,000,State - ASSAM,Rural,18,288071,60941,227130
C2308,18,000,State - ASSAM,Rural,19,242269,53026,189243
C2308,18,000,State - ASSAM,Rural,20-24,1274492,351112,923380
C2308,18,000,State - ASSAM,Rural,25-29,1203447,412493,790954
C2308,18,000,State - ASSAM,Rural,30-34,964890,380079,584811
C2308,18,000,State - ASSAM,Rural,35-39,917721,421633,496088
C2308,18,000,State - ASSAM,Rural,40-44,713502,380774,332728
C2308,18,000,State - ASSAM,Rural,45-49,617507,356225,261282
C2308,18,000,State - ASSAM,Rural,50-54,454998,284182,170816
C2308,18,000,State - ASSAM,Rural,55-59,331219,215454,115765
C2308,18,000,State - ASSAM,Rural,60-64,321702,229184,92518
C2308,18,000,State - ASSAM,Rural,65-69,210605,154101,56504
C2308,18,000,State - ASSAM,Rural,70-74,160721,128097,32624
C2308,18,000,State - ASSAM,Rural,75-79,72216,57730,14486
C2308,18,000,State - ASSAM,Rural,80+,97980,78889,19091
C2308,18,000,State - ASSAM,Rural,Age not stated,7167,3614,3553
C2308,18,000,State - ASSAM,Urban,All ages,2138088,507993,1630095
C2308,18,000,State - ASSAM,Urban,0-6,218908,218908,0
C2308,18,000,State - ASSAM,Urban,7,36109,6283,29826
C2308,18,000,State - ASSAM,Urban,8,34966,2848,32118
C2308,18,000,State - ASSAM,Urban,9,33644,2112,31532
C2308,18,000,State - ASSAM,Urban,10,38729,2645,36084
C2308,18,000,State - ASSAM,Urban,11,36684,1794,34890
C2308,18,000,State - ASSAM,Urban,12,38948,1908,37040
C2308,18,000,State - ASSAM,Urban,13,37310,1721,35589
C2308,18,000,State - ASSAM,Urban,14,38673,2008,36665
C2308,18,000,State - ASSAM,Urban,15,39031,2290,36741
C2308,18,000,State - ASSAM,Urban,16,38098,2232,35866
C2308,18,000,State - ASSAM,Urban,17,36231,2021,34210
C2308,18,000,State - ASSAM,Urban,18,43945,3349,40596
C2308,18,000,State - ASSAM,Urban,19,40188,2900,37288
C2308,18,000,State - ASSAM,Urban,20-24,219333,19646,199687
C2308,18,000,State - ASSAM,Urban,25-29,218658,24089,194569
C2308,18,000,State - ASSAM,Urban,30-34,190923,24632,166291
C2308,18,000,State - ASSAM,Urban,35-39,189073,30458,158615
C2308,18,000,State - ASSAM,Urban,40-44,152241,28757,123484
C2308,18,000,State - ASSAM,Urban,45-49,131661,27579,104082
C2308,18,000,State - ASSAM,Urban,50-54,95105,22676,72429
C2308,18,000,State - ASSAM,Urban,55-59,67364,16526,50838
C2308,18,000,State - ASSAM,Urban,60-64,59433,19134,40299
C2308,18,000,State - ASSAM,Urban,65-69,39064,13547,25517
C2308,18,000,State - ASSAM,Urban,70-74,28111,12296,15815
C2308,18,000,State - ASSAM,Urban,75-79,15537,6416,9121
C2308,18,000,State - ASSAM,Urban,80+,18358,8804,9554
C2308,18,000,State - ASSAM,Urban,Age not stated,1763,414,1349
C2308,19,000,State - WEST BENGAL,Total,All ages,44467088,16747617,27719471
C2308,19,000,State - WEST BENGAL,Total,0-6,5171070,5171070,0
C2308,19,000,State - WEST BENGAL,Total,7,816280,182341,633939
C2308,19,000,State - WEST BENGAL,Total,8,840173,99552,740621
C2308,19,000,State - WEST BENGAL,Total,9,792804,64365,728439
C2308,19,000,State - WEST BENGAL,Total,10,953312,82491,870821
C2308,19,000,State - WEST BENGAL,Total,11,826152,52537,773615
C2308,19,000,State - WEST BENGAL,Total,12,924494,63991,860503
C2308,19,000,State - WEST BENGAL,Total,13,872702,55198,817504
C2308,19,000,State - WEST BENGAL,Total,14,902357,64641,837716
C2308,19,000,State - WEST BENGAL,Total,15,896929,77991,818938
C2308,19,000,State - WEST BENGAL,Total,16,848673,81807,766866
C2308,19,000,State - WEST BENGAL,Total,17,746690,73609,673081
C2308,19,000,State - WEST BENGAL,Total,18,1017917,138358,879559
C2308,19,000,State - WEST BENGAL,Total,19,845497,115050,730447
C2308,19,000,State - WEST BENGAL,Total,20-24,4335692,798015,3537677
C2308,19,000,State - WEST BENGAL,Total,25-29,3953005,940757,3012248
C2308,19,000,State - WEST BENGAL,Total,30-34,3376931,958370,2418561
C2308,19,000,State - WEST BENGAL,Total,35-39,3489285,1224933,2264352
C2308,19,000,State - WEST BENGAL,Total,40-44,2933456,1209062,1724394
C2308,19,000,State - WEST BENGAL,Total,45-49,2521507,1119796,1401711
C2308,19,000,State - WEST BENGAL,Total,50-54,1940648,930413,1010235
C2308,19,000,State - WEST BENGAL,Total,55-59,1521747,779118,742629
C2308,19,000,State - WEST BENGAL,Total,60-64,1339053,793817,545236
C2308,19,000,State - WEST BENGAL,Total,65-69,991713,622469,369244
C2308,19,000,State - WEST BENGAL,Total,70-74,703726,472943,230783
C2308,19,000,State - WEST BENGAL,Total,75-79,379551,250566,128985
C2308,19,000,State - WEST BENGAL,Total,80+,477025,308625,168400
C2308,19,000,State - WEST BENGAL,Total,Age not stated,48699,15732,32967
C2308,19,000,State - WEST BENGAL,Rural,All ages,30338168,12972586,17365582
C2308,19,000,State - WEST BENGAL,Rural,0-6,3828055,3828055,0
C2308,19,000,State - WEST BENGAL,Rural,7,597034,143799,453235
C2308,19,000,State - WEST BENGAL,Rural,8,621022,78464,542558
C2308,19,000,State - WEST BENGAL,Rural,9,579953,49542,530411
C2308,19,000,State - WEST BENGAL,Rural,10,695439,62991,632448
C2308,19,000,State - WEST BENGAL,Rural,11,598559,39780,558779
C2308,19,000,State - WEST BENGAL,Rural,12,680337,49891,630446
C2308,19,000,State - WEST BENGAL,Rural,13,641374,42851,598523
C2308,19,000,State - WEST BENGAL,Rural,14,660357,50215,610142
C2308,19,000,State - WEST BENGAL,Rural,15,649449,60626,588823
C2308,19,000,State - WEST BENGAL,Rural,16,605728,63779,541949
C2308,19,000,State - WEST BENGAL,Rural,17,517485,56561,460924
C2308,19,000,State - WEST BENGAL,Rural,18,720556,108685,611871
C2308,19,000,State - WEST BENGAL,Rural,19,589873,90279,499594
C2308,19,000,State - WEST BENGAL,Rural,20-24,2980049,636232,2343817
C2308,19,000,State - WEST BENGAL,Rural,25-29,2631501,751078,1880423
C2308,19,000,State - WEST BENGAL,Rural,30-34,2197087,763956,1433131
C2308,19,000,State - WEST BENGAL,Rural,35-39,2290624,976940,1313684
C2308,19,000,State - WEST BENGAL,Rural,40-44,1924134,965791,958343
C2308,19,000,State - WEST BENGAL,Rural,45-49,1614943,883411,731532
C2308,19,000,State - WEST BENGAL,Rural,50-54,1224592,732016,492576
C2308,19,000,State - WEST BENGAL,Rural,55-59,962669,617050,345619
C2308,19,000,State - WEST BENGAL,Rural,60-64,864930,627839,237091
C2308,19,000,State - WEST BENGAL,Rural,65-69,654549,496597,157952
C2308,19,000,State - WEST BENGAL,Rural,70-74,455273,366572,88701
C2308,19,000,State - WEST BENGAL,Rural,75-79,238972,192924,46048
C2308,19,000,State - WEST BENGAL,Rural,80+,291610,226966,64644
C2308,19,000,State - WEST BENGAL,Rural,Age not stated,22014,9696,12318
C2308,19,000,State - WEST BENGAL,Urban,All ages,14128920,3775031,10353889
C2308,19,000,State - WEST BENGAL,Urban,0-6,1343015,1343015,0
C2308,19,000,State - WEST BENGAL,Urban,7,219246,38542,180704
C2308,19,000,State - WEST BENGAL,Urban,8,219151,21088,198063
C2308,19,000,State - WEST BENGAL,Urban,9,212851,14823,198028
C2308,19,000,State - WEST BENGAL,Urban,10,257873,19500,238373
C2308,19,000,State - WEST BENGAL,Urban,11,227593,12757,214836
C2308,19,000,State - WEST BENGAL,Urban,12,244157,14100,230057
C2308,19,000,State - WEST BENGAL,Urban,13,231328,12347,218981
C2308,19,000,State - WEST BENGAL,Urban,14,242000,14426,227574
C2308,19,000,State - WEST BENGAL,Urban,15,247480,17365,230115
C2308,19,000,State - WEST BENGAL,Urban,16,242945,18028,224917
C2308,19,000,State - WEST BENGAL,Urban,17,229205,17048,212157
C2308,19,000,State - WEST BENGAL,Urban,18,297361,29673,267688
C2308,19,000,State - WEST BENGAL,Urban,19,255624,24771,230853
C2308,19,000,State - WEST BENGAL,Urban,20-24,1355643,161783,1193860
C2308,19,000,State - WEST BENGAL,Urban,25-29,1321504,189679,1131825
C2308,19,000,State - WEST BENGAL,Urban,30-34,1179844,194414,985430
C2308,19,000,State - WEST BENGAL,Urban,35-39,1198661,247993,950668
C2308,19,000,State - WEST BENGAL,Urban,40-44,1009322,243271,766051
C2308,19,000,State - WEST BENGAL,Urban,45-49,906564,236385,670179
C2308,19,000,State - WEST BENGAL,Urban,50-54,716056,198397,517659
C2308,19,000,State - WEST BENGAL,Urban,55-59,559078,162068,397010
C2308,19,000,State - WEST BENGAL,Urban,60-64,474123,165978,308145
C2308,19,000,State - WEST BENGAL,Urban,65-69,337164,125872,211292
C2308,19,000,State - WEST BENGAL,Urban,70-74,248453,106371,142082
C2308,19,000,State - WEST BENGAL,Urban,75-79,140579,57642,82937
C2308,19,000,State - WEST BENGAL,Urban,80+,185415,81659,103756
C2308,19,000,State - WEST BENGAL,Urban,Age not stated,26685,6036,20649
C2308,20,000,State - JHARKHAND,Total,All ages,16057819,8612269,7445550
C2308,20,000,State - JHARKHAND,Total,0-6,2622348,2622348,0
C2308,20,000,State - JHARKHAND,Total,7,388551,127053,261498
C2308,20,000,State - JHARKHAND,Total,8,450379,87492,362887
C2308,20,000,State - JHARKHAND,Total,9,336431,47346,289085
C2308,20,000,State - JHARKHAND,Total,10,483063,65453,417610
C2308,20,000,State - JHARKHAND,Total,11,335816,34792,301024
C2308,20,000,State - JHARKHAND,Total,12,454181,51503,402678
C2308,20,000,State - JHARKHAND,Total,13,355848,36299,319549
C2308,20,000,State - JHARKHAND,Total,14,362861,42437,320424
C2308,20,000,State - JHARKHAND,Total,15,353636,53742,299894
C2308,20,000,State - JHARKHAND,Total,16,309714,51444,258270
C2308,20,000,State - JHARKHAND,Total,17,232394,41922,190472
C2308,20,000,State - JHARKHAND,Total,18,349269,94862,254407
C2308,20,000,State - JHARKHAND,Total,19,245368,68171,177197
C2308,20,000,State - JHARKHAND,Total,20-24,1396359,516675,879684
C2308,20,000,State - JHARKHAND,Total,25-29,1310325,596932,713393
C2308,20,000,State - JHARKHAND,Total,30-34,1141430,604019,537411
C2308,20,000,State - JHARKHAND,Total,35-39,1044089,621128,422961
C2308,20,000,State - JHARKHAND,Total,40-44,858085,561862,296223
C2308,20,000,State - JHARKHAND,Total,45-49,735128,511547,223581
C2308,20,000,State - JHARKHAND,Total,50-54,565499,407541,157958
C2308,20,000,State - JHARKHAND,Total,55-59,497630,377617,120013
C2308,20,000,State - JHARKHAND,Total,60-64,482917,389173,93744
C2308,20,000,State - JHARKHAND,Total,65-69,317545,263361,54184
C2308,20,000,State - JHARKHAND,Total,70-74,196230,166889,29341
C2308,20,000,State - JHARKHAND,Total,75-79,84412,70391,14021
C2308,20,000,State - JHARKHAND,Total,80+,93829,76182,17647
C2308,20,000,State - JHARKHAND,Total,Age not stated,54482,24088,30394
C2308,20,000,State - JHARKHAND,Rural,All ages,12278587,7318240,4960347
C2308,20,000,State - JHARKHAND,Rural,0-6,2136013,2136013,0
C2308,20,000,State - JHARKHAND,Rural,7,310940,109440,201500
C2308,20,000,State - JHARKHAND,Rural,8,368251,77378,290873
C2308,20,000,State - JHARKHAND,Rural,9,269135,41514,227621
C2308,20,000,State - JHARKHAND,Rural,10,391418,57382,334036
C2308,20,000,State - JHARKHAND,Rural,11,263230,30258,232972
C2308,20,000,State - JHARKHAND,Rural,12,364915,45640,319275
C2308,20,000,State - JHARKHAND,Rural,13,276473,31853,244620
C2308,20,000,State - JHARKHAND,Rural,14,279110,37018,242092
C2308,20,000,State - JHARKHAND,Rural,15,269010,47178,221832
C2308,20,000,State - JHARKHAND,Rural,16,226922,44910,182012
C2308,20,000,State - JHARKHAND,Rural,17,161796,36483,125313
C2308,20,000,State - JHARKHAND,Rural,18,257457,84227,173230
C2308,20,000,State - JHARKHAND,Rural,19,175861,60552,115309
C2308,20,000,State - JHARKHAND,Rural,20-24,1021175,459751,561424
C2308,20,000,State - JHARKHAND,Rural,25-29,965535,528014,437521
C2308,20,000,State - JHARKHAND,Rural,30-34,847978,530284,317694
C2308,20,000,State - JHARKHAND,Rural,35-39,770806,536209,234597
C2308,20,000,State - JHARKHAND,Rural,40-44,635768,481529,154239
C2308,20,000,State - JHARKHAND,Rural,45-49,541511,433840,107671
C2308,20,000,State - JHARKHAND,Rural,50-54,413692,342105,71587
C2308,20,000,State - JHARKHAND,Rural,55-59,376767,321172,55595
C2308,20,000,State - JHARKHAND,Rural,60-64,380411,335907,44504
C2308,20,000,State - JHARKHAND,Rural,65-69,255496,229621,25875
C2308,20,000,State - JHARKHAND,Rural,70-74,155920,143025,12895
C2308,20,000,State - JHARKHAND,Rural,75-79,65428,59803,5625
C2308,20,000,State - JHARKHAND,Rural,80+,70730,62397,8333
C2308,20,000,State - JHARKHAND,Rural,Age not stated,26839,14737,12102
C2308,20,000,State - JHARKHAND,Urban,All ages,3779232,1294029,2485203
C2308,20,000,State - JHARKHAND,Urban,0-6,486335,486335,0
C2308,20,000,State - JHARKHAND,Urban,7,77611,17613,59998
C2308,20,000,State - JHARKHAND,Urban,8,82128,10114,72014
C2308,20,000,State - JHARKHAND,Urban,9,67296,5832,61464
C2308,20,000,State - JHARKHAND,Urban,10,91645,8071,83574
C2308,20,000,State - JHARKHAND,Urban,11,72586,4534,68052
C2308,20,000,State - JHARKHAND,Urban,12,89266,5863,83403
C2308,20,000,State - JHARKHAND,Urban,13,79375,4446,74929
C2308,20,000,State - JHARKHAND,Urban,14,83751,5419,78332
C2308,20,000,State - JHARKHAND,Urban,15,84626,6564,78062
C2308,20,000,State - JHARKHAND,Urban,16,82792,6534,76258
C2308,20,000,State - JHARKHAND,Urban,17,70598,5439,65159
C2308,20,000,State - JHARKHAND,Urban,18,91812,10635,81177
C2308,20,000,State - JHARKHAND,Urban,19,69507,7619,61888
C2308,20,000,State - JHARKHAND,Urban,20-24,375184,56924,318260
C2308,20,000,State - JHARKHAND,Urban,25-29,344790,68918,275872
C2308,20,000,State - JHARKHAND,Urban,30-34,293452,73735,219717
C2308,20,000,State - JHARKHAND,Urban,35-39,273283,84919,188364
C2308,20,000,State - JHARKHAND,Urban,40-44,222317,80333,141984
C2308,20,000,State - JHARKHAND,Urban,45-49,193617,77707,115910
C2308,20,000,State - JHARKHAND,Urban,50-54,151807,65436,86371
C2308,20,000,State - JHARKHAND,Urban,55-59,120863,56445,64418
C2308,20,000,State - JHARKHAND,Urban,60-64,102506,53266,49240
C2308,20,000,State - JHARKHAND,Urban,65-69,62049,33740,28309
C2308,20,000,State - JHARKHAND,Urban,70-74,40310,23864,16446
C2308,20,000,State - JHARKHAND,Urban,75-79,18984,10588,8396
C2308,20,000,State - JHARKHAND,Urban,80+,23099,13785,9314
C2308,20,000,State - JHARKHAND,Urban,Age not stated,27643,9351,18292
C2308,21,000,State - ODISHA,Total,All ages,20762082,9109168,11652914
C2308,21,000,State - ODISHA,Total,0-6,2556697,2556697,0
C2308,21,000,State - ODISHA,Total,7,408833,123393,285440
C2308,21,000,State - ODISHA,Total,8,416854,67181,349673
C2308,21,000,State - ODISHA,Total,9,381947,40209,341738
C2308,21,000,State - ODISHA,Total,10,445392,51658,393734
C2308,21,000,State - ODISHA,Total,11,411221,32904,378317
C2308,21,000,State - ODISHA,Total,12,449696,42915,406781
C2308,21,000,State - ODISHA,Total,13,419236,35283,383953
C2308,21,000,State - ODISHA,Total,14,419545,39742,379803
C2308,21,000,State - ODISHA,Total,15,432703,55332,377371
C2308,21,000,State - ODISHA,Total,16,387017,53579,333438
C2308,21,000,State - ODISHA,Total,17,345307,48059,297248
C2308,21,000,State - ODISHA,Total,18,445918,84380,361538
C2308,21,000,State - ODISHA,Total,19,341769,60056,281713
C2308,21,000,State - ODISHA,Total,20-24,1912588,426938,1485650
C2308,21,000,State - ODISHA,Total,25-29,1801161,499028,1302133
C2308,21,000,State - ODISHA,Total,30-34,1560758,534843,1025915
C2308,21,000,State - ODISHA,Total,35-39,1522503,635844,886659
C2308,21,000,State - ODISHA,Total,40-44,1303554,633283,670271
C2308,21,000,State - ODISHA,Total,45-49,1121664,595554,526110
C2308,21,000,State - ODISHA,Total,50-54,890288,505139,385149
C2308,21,000,State - ODISHA,Total,55-59,739429,455414,284015
C2308,21,000,State - ODISHA,Total,60-64,736426,529140,207286
C2308,21,000,State - ODISHA,Total,65-69,491676,371747,119929
C2308,21,000,State - ODISHA,Total,70-74,387435,309012,78423
C2308,21,000,State - ODISHA,Total,75-79,181506,143535,37971
C2308,21,000,State - ODISHA,Total,80+,193135,153208,39927
C2308,21,000,State - ODISHA,Total,Age not stated,57824,25095,32729
C2308,21,000,State - ODISHA,Rural,All ages,17384359,8160996,9223363
C2308,21,000,State - ODISHA,Rural,0-6,2200038,2200038,0
C2308,21,000,State - ODISHA,Rural,7,350622,111707,238915
C2308,21,000,State - ODISHA,Rural,8,360011,61565,298446
C2308,21,000,State - ODISHA,Rural,9,329358,36713,292645
C2308,21,000,State - ODISHA,Rural,10,382754,46885,335869
C2308,21,000,State - ODISHA,Rural,11,351479,30016,321463
C2308,21,000,State - ODISHA,Rural,12,385207,39298,345909
C2308,21,000,State - ODISHA,Rural,13,357091,32296,324795
C2308,21,000,State - ODISHA,Rural,14,356322,36230,320092
C2308,21,000,State - ODISHA,Rural,15,366179,50920,315259
C2308,21,000,State - ODISHA,Rural,16,323950,49145,274805
C2308,21,000,State - ODISHA,Rural,17,285013,43854,241159
C2308,21,000,State - ODISHA,Rural,18,370555,77459,293096
C2308,21,000,State - ODISHA,Rural,19,277485,54770,222715
C2308,21,000,State - ODISHA,Rural,20-24,1565184,388909,1176275
C2308,21,000,State - ODISHA,Rural,25-29,1472606,453191,1019415
C2308,21,000,State - ODISHA,Rural,30-34,1272986,486876,786110
C2308,21,000,State - ODISHA,Rural,35-39,1244799,577885,666914
C2308,21,000,State - ODISHA,Rural,40-44,1069929,575744,494185
C2308,21,000,State - ODISHA,Rural,45-49,922862,540300,382562
C2308,21,000,State - ODISHA,Rural,50-54,739533,456923,282610
C2308,21,000,State - ODISHA,Rural,55-59,628219,416331,211888
C2308,21,000,State - ODISHA,Rural,60-64,638752,483758,154994
C2308,21,000,State - ODISHA,Rural,65-69,430391,341591,88800
C2308,21,000,State - ODISHA,Rural,70-74,337254,280403,56851
C2308,21,000,State - ODISHA,Rural,75-79,156525,130144,26381
C2308,21,000,State - ODISHA,Rural,80+,162515,135782,26733
C2308,21,000,State - ODISHA,Rural,Age not stated,46740,22263,24477
C2308,21,000,State - ODISHA,Urban,All ages,3377723,948172,2429551
C2308,21,000,State - ODISHA,Urban,0-6,356659,356659,0
C2308,21,000,State - ODISHA,Urban,7,58211,11686,46525
C2308,21,000,State - ODISHA,Urban,8,56843,5616,51227
C2308,21,000,State - ODISHA,Urban,9,52589,3496,49093
C2308,21,000,State - ODISHA,Urban,10,62638,4773,57865
C2308,21,000,State - ODISHA,Urban,11,59742,2888,56854
C2308,21,000,State - ODISHA,Urban,12,64489,3617,60872
C2308,21,000,State - ODISHA,Urban,13,62145,2987,59158
C2308,21,000,State - ODISHA,Urban,14,63223,3512,59711
C2308,21,000,State - ODISHA,Urban,15,66524,4412,62112
C2308,21,000,State - ODISHA,Urban,16,63067,4434,58633
C2308,21,000,State - ODISHA,Urban,17,60294,4205,56089
C2308,21,000,State - ODISHA,Urban,18,75363,6921,68442
C2308,21,000,State - ODISHA,Urban,19,64284,5286,58998
C2308,21,000,State - ODISHA,Urban,20-24,347404,38029,309375
C2308,21,000,State - ODISHA,Urban,25-29,328555,45837,282718
C2308,21,000,State - ODISHA,Urban,30-34,287772,47967,239805
C2308,21,000,State - ODISHA,Urban,35-39,277704,57959,219745
C2308,21,000,State - ODISHA,Urban,40-44,233625,57539,176086
C2308,21,000,State - ODISHA,Urban,45-49,198802,55254,143548
C2308,21,000,State - ODISHA,Urban,50-54,150755,48216,102539
C2308,21,000,State - ODISHA,Urban,55-59,111210,39083,72127
C2308,21,000,State - ODISHA,Urban,60-64,97674,45382,52292
C2308,21,000,State - ODISHA,Urban,65-69,61285,30156,31129
C2308,21,000,State - ODISHA,Urban,70-74,50181,28609,21572
C2308,21,000,State - ODISHA,Urban,75-79,24981,13391,11590
C2308,21,000,State - ODISHA,Urban,80+,30620,17426,13194
C2308,21,000,State - ODISHA,Urban,Age not stated,11084,2832,8252
C2308,22,000,State - CHHATTISGARH,Total,All ages,12712303,6140274,6572029
C2308,22,000,State - CHHATTISGARH,Total,0-6,1801754,1801754,0
C2308,22,000,State - CHHATTISGARH,Total,7,266429,85751,180678
C2308,22,000,State - CHHATTISGARH,Total,8,281478,41189,240289
C2308,22,000,State - CHHATTISGARH,Total,9,259113,22812,236301
C2308,22,000,State - CHHATTISGARH,Total,10,313874,28473,285401
C2308,22,000,State - CHHATTISGARH,Total,11,280204,16492,263712
C2308,22,000,State - CHHATTISGARH,Total,12,291195,22108,269087
C2308,22,000,State - CHHATTISGARH,Total,13,266666,18124,248542
C2308,22,000,State - CHHATTISGARH,Total,14,270889,21150,249739
C2308,22,000,State - CHHATTISGARH,Total,15,269780,29043,240737
C2308,22,000,State - CHHATTISGARH,Total,16,267711,29090,238621
C2308,22,000,State - CHHATTISGARH,Total,17,232412,25198,207214
C2308,22,000,State - CHHATTISGARH,Total,18,284871,44266,240605
C2308,22,000,State - CHHATTISGARH,Total,19,225617,34209,191408
C2308,22,000,State - CHHATTISGARH,Total,20-24,1196119,263214,932905
C2308,22,000,State - CHHATTISGARH,Total,25-29,1008062,315776,692286
C2308,22,000,State - CHHATTISGARH,Total,30-34,917035,387743,529292
C2308,22,000,State - CHHATTISGARH,Total,35-39,888149,475323,412826
C2308,22,000,State - CHHATTISGARH,Total,40-44,780151,488906,291245
C2308,22,000,State - CHHATTISGARH,Total,45-49,641400,436643,204757
C2308,22,000,State - CHHATTISGARH,Total,50-54,482621,343809,138812
C2308,22,000,State - CHHATTISGARH,Total,55-59,400015,301222,98793
C2308,22,000,State - CHHATTISGARH,Total,60-64,394786,319982,74804
C2308,22,000,State - CHHATTISGARH,Total,65-69,289474,244373,45101
C2308,22,000,State - CHHATTISGARH,Total,70-74,198751,173897,24854
C2308,22,000,State - CHHATTISGARH,Total,75-79,91033,79438,11595
C2308,22,000,State - CHHATTISGARH,Total,80+,101706,85478,16228
C2308,22,000,State - CHHATTISGARH,Total,Age not stated,11008,4811,6197
C2308,22,000,State - CHHATTISGARH,Rural,All ages,9810535,5204591,4605944
C2308,22,000,State - CHHATTISGARH,Rural,0-6,1445355,1445355,0
C2308,22,000,State - CHHATTISGARH,Rural,7,211449,73975,137474
C2308,22,000,State - CHHATTISGARH,Rural,8,227434,36740,190694
C2308,22,000,State - CHHATTISGARH,Rural,9,209295,20337,188958
C2308,22,000,State - CHHATTISGARH,Rural,10,253431,25224,228207
C2308,22,000,State - CHHATTISGARH,Rural,11,224521,14672,209849
C2308,22,000,State - CHHATTISGARH,Rural,12,233092,19936,213156
C2308,22,000,State - CHHATTISGARH,Rural,13,210672,16275,194397
C2308,22,000,State - CHHATTISGARH,Rural,14,212837,19005,193832
C2308,22,000,State - CHHATTISGARH,Rural,15,211394,26098,185296
C2308,22,000,State - CHHATTISGARH,Rural,16,209170,26234,182936
C2308,22,000,State - CHHATTISGARH,Rural,17,177796,22533,155263
C2308,22,000,State - CHHATTISGARH,Rural,18,220173,39908,180265
C2308,22,000,State - CHHATTISGARH,Rural,19,170184,30567,139617
C2308,22,000,State - CHHATTISGARH,Rural,20-24,888767,233364,655403
C2308,22,000,State - CHHATTISGARH,Rural,25-29,737655,276385,461270
C2308,22,000,State - CHHATTISGARH,Rural,30-34,683545,338754,344791
C2308,22,000,State - CHHATTISGARH,Rural,35-39,666074,411810,254264
C2308,22,000,State - CHHATTISGARH,Rural,40-44,588938,422281,166657
C2308,22,000,State - CHHATTISGARH,Rural,45-49,481879,373541,108338
C2308,22,000,State - CHHATTISGARH,Rural,50-54,364932,292625,72307
C2308,22,000,State - CHHATTISGARH,Rural,55-59,312099,259334,52765
C2308,22,000,State - CHHATTISGARH,Rural,60-64,314817,275605,39212
C2308,22,000,State - CHHATTISGARH,Rural,65-69,234210,211581,22629
C2308,22,000,State - CHHATTISGARH,Rural,70-74,160401,148864,11537
C2308,22,000,State - CHHATTISGARH,Rural,75-79,73190,68242,4948
C2308,22,000,State - CHHATTISGARH,Rural,80+,80480,71897,8583
C2308,22,000,State - CHHATTISGARH,Rural,Age not stated,6745,3449,3296
C2308,22,000,State - CHHATTISGARH,Urban,All ages,2901768,935683,1966085
C2308,22,000,State - CHHATTISGARH,Urban,0-6,356399,356399,0
C2308,22,000,State - CHHATTISGARH,Urban,7,54980,11776,43204
C2308,22,000,State - CHHATTISGARH,Urban,8,54044,4449,49595
C2308,22,000,State - CHHATTISGARH,Urban,9,49818,2475,47343
C2308,22,000,State - CHHATTISGARH,Urban,10,60443,3249,57194
C2308,22,000,State - CHHATTISGARH,Urban,11,55683,1820,53863
C2308,22,000,State - CHHATTISGARH,Urban,12,58103,2172,55931
C2308,22,000,State - CHHATTISGARH,Urban,13,55994,1849,54145
C2308,22,000,State - CHHATTISGARH,Urban,14,58052,2145,55907
C2308,22,000,State - CHHATTISGARH,Urban,15,58386,2945,55441
C2308,22,000,State - CHHATTISGARH,Urban,16,58541,2856,55685
C2308,22,000,State - CHHATTISGARH,Urban,17,54616,2665,51951
C2308,22,000,State - CHHATTISGARH,Urban,18,64698,4358,60340
C2308,22,000,State - CHHATTISGARH,Urban,19,55433,3642,51791
C2308,22,000,State - CHHATTISGARH,Urban,20-24,307352,29850,277502
C2308,22,000,State - CHHATTISGARH,Urban,25-29,270407,39391,231016
C2308,22,000,State - CHHATTISGARH,Urban,30-34,233490,48989,184501
C2308,22,000,State - CHHATTISGARH,Urban,35-39,222075,63513,158562
C2308,22,000,State - CHHATTISGARH,Urban,40-44,191213,66625,124588
C2308,22,000,State - CHHATTISGARH,Urban,45-49,159521,63102,96419
C2308,22,000,State - CHHATTISGARH,Urban,50-54,117689,51184,66505
C2308,22,000,State - CHHATTISGARH,Urban,55-59,87916,41888,46028
C2308,22,000,State - CHHATTISGARH,Urban,60-64,79969,44377,35592
C2308,22,000,State - CHHATTISGARH,Urban,65-69,55264,32792,22472
C2308,22,000,State - CHHATTISGARH,Urban,70-74,38350,25033,13317
C2308,22,000,State - CHHATTISGARH,Urban,75-79,17843,11196,6647
C2308,22,000,State - CHHATTISGARH,Urban,80+,21226,13581,7645
C2308,22,000,State - CHHATTISGARH,Urban,Age not stated,4263,1362,2901
C2308,23,000,State - MADHYA PRADESH,Total,All ages,35014503,17337662,17676841
C2308,23,000,State - MADHYA PRADESH,Total,0-6,5173223,5173223,0
C2308,23,000,State - MADHYA PRADESH,Total,7,778329,220554,557775
C2308,23,000,State - MADHYA PRADESH,Total,8,864149,126563,737586
C2308,23,000,State - MADHYA PRADESH,Total,9,738100,73668,664432
C2308,23,000,State - MADHYA PRADESH,Total,10,950852,100166,850686
C2308,23,000,State - MADHYA PRADESH,Total,11,783746,57445,726301
C2308,23,000,State - MADHYA PRADESH,Total,12,871117,73636,797481
C2308,23,000,State - MADHYA PRADESH,Total,13,753044,59030,694014
C2308,23,000,State - MADHYA PRADESH,Total,14,766413,70609,695804
C2308,23,000,State - MADHYA PRADESH,Total,15,754630,88480,666150
C2308,23,000,State - MADHYA PRADESH,Total,16,724096,93695,630401
C2308,23,000,State - MADHYA PRADESH,Total,17,598938,80235,518703
C2308,23,000,State - MADHYA PRADESH,Total,18,797945,161918,636027
C2308,23,000,State - MADHYA PRADESH,Total,19,591108,123041,468067
C2308,23,000,State - MADHYA PRADESH,Total,20-24,3173491,939709,2233782
C2308,23,000,State - MADHYA PRADESH,Total,25-29,2799181,1100043,1699138
C2308,23,000,State - MADHYA PRADESH,Total,30-34,2564255,1215857,1348398
C2308,23,000,State - MADHYA PRADESH,Total,35-39,2368207,1296698,1071509
C2308,23,000,State - MADHYA PRADESH,Total,40-44,2020586,1219001,801585
C2308,23,000,State - MADHYA PRADESH,Total,45-49,1684163,1087937,596226
C2308,23,000,State - MADHYA PRADESH,Total,50-54,1247850,837229,410621
C2308,23,000,State - MADHYA PRADESH,Total,55-59,1027834,740313,287521
C2308,23,000,State - MADHYA PRADESH,Total,60-64,997947,770391,227556
C2308,23,000,State - MADHYA PRADESH,Total,65-69,747056,604372,142684
C2308,23,000,State - MADHYA PRADESH,Total,70-74,562175,475336,86839
C2308,23,000,State - MADHYA PRADESH,Total,75-79,278548,234681,43867
C2308,23,000,State - MADHYA PRADESH,Total,80+,358034,296254,61780
C2308,23,000,State - MADHYA PRADESH,Total,Age not stated,39486,17578,21908
C2308,23,000,State - MADHYA PRADESH,Rural,All ages,25408016,14181012,11227004
C2308,23,000,State - MADHYA PRADESH,Rural,0-6,3995738,3995738,0
C2308,23,000,State - MADHYA PRADESH,Rural,7,594564,178910,415654
C2308,23,000,State - MADHYA PRADESH,Rural,8,676876,106420,570456
C2308,23,000,State - MADHYA PRADESH,Rural,9,569518,60697,508821
C2308,23,000,State - MADHYA PRADESH,Rural,10,737551,82846,654705
C2308,23,000,State - MADHYA PRADESH,Rural,11,597252,47365,549887
C2308,23,000,State - MADHYA PRADESH,Rural,12,671006,62630,608376
C2308,23,000,State - MADHYA PRADESH,Rural,13,565230,49578,515652
C2308,23,000,State - MADHYA PRADESH,Rural,14,571895,59961,511934
C2308,23,000,State - MADHYA PRADESH,Rural,15,557183,75325,481858
C2308,23,000,State - MADHYA PRADESH,Rural,16,530468,80469,449999
C2308,23,000,State - MADHYA PRADESH,Rural,17,421306,68717,352589
C2308,23,000,State - MADHYA PRADESH,Rural,18,576010,141608,434402
C2308,23,000,State - MADHYA PRADESH,Rural,19,412406,107309,305097
C2308,23,000,State - MADHYA PRADESH,Rural,20-24,2197131,815348,1381783
C2308,23,000,State - MADHYA PRADESH,Rural,25-29,1923404,943845,979559
C2308,23,000,State - MADHYA PRADESH,Rural,30-34,1797462,1038450,759012
C2308,23,000,State - MADHYA PRADESH,Rural,35-39,1657138,1092473,564665
C2308,23,000,State - MADHYA PRADESH,Rural,40-44,1409839,1019440,390399
C2308,23,000,State - MADHYA PRADESH,Rural,45-49,1164791,901816,262975
C2308,23,000,State - MADHYA PRADESH,Rural,50-54,859466,687531,171935
C2308,23,000,State - MADHYA PRADESH,Rural,55-59,733099,613988,119111
C2308,23,000,State - MADHYA PRADESH,Rural,60-64,725303,632032,93271
C2308,23,000,State - MADHYA PRADESH,Rural,65-69,556687,498529,58158
C2308,23,000,State - MADHYA PRADESH,Rural,70-74,418606,384806,33800
C2308,23,000,State - MADHYA PRADESH,Rural,75-79,206337,190643,15694
C2308,23,000,State - MADHYA PRADESH,Rural,80+,259315,232443,26872
C2308,23,000,State - MADHYA PRADESH,Rural,Age not stated,22435,12095,10340
C2308,23,000,State - MADHYA PRADESH,Urban,All ages,9606487,3156650,6449837
C2308,23,000,State - MADHYA PRADESH,Urban,0-6,1177485,1177485,0
C2308,23,000,State - MADHYA PRADESH,Urban,7,183765,41644,142121
C2308,23,000,State - MADHYA PRADESH,Urban,8,187273,20143,167130
C2308,23,000,State - MADHYA PRADESH,Urban,9,168582,12971,155611
C2308,23,000,State - MADHYA PRADESH,Urban,10,213301,17320,195981
C2308,23,000,State - MADHYA PRADESH,Urban,11,186494,10080,176414
C2308,23,000,State - MADHYA PRADESH,Urban,12,200111,11006,189105
C2308,23,000,State - MADHYA PRADESH,Urban,13,187814,9452,178362
C2308,23,000,State - MADHYA PRADESH,Urban,14,194518,10648,183870
C2308,23,000,State - MADHYA PRADESH,Urban,15,197447,13155,184292
C2308,23,000,State - MADHYA PRADESH,Urban,16,193628,13226,180402
C2308,23,000,State - MADHYA PRADESH,Urban,17,177632,11518,166114
C2308,23,000,State - MADHYA PRADESH,Urban,18,221935,20310,201625
C2308,23,000,State - MADHYA PRADESH,Urban,19,178702,15732,162970
C2308,23,000,State - MADHYA PRADESH,Urban,20-24,976360,124361,851999
C2308,23,000,State - MADHYA PRADESH,Urban,25-29,875777,156198,719579
C2308,23,000,State - MADHYA PRADESH,Urban,30-34,766793,177407,589386
C2308,23,000,State - MADHYA PRADESH,Urban,35-39,711069,204225,506844
C2308,23,000,State - MADHYA PRADESH,Urban,40-44,610747,199561,411186
C2308,23,000,State - MADHYA PRADESH,Urban,45-49,519372,186121,333251
C2308,23,000,State - MADHYA PRADESH,Urban,50-54,388384,149698,238686
C2308,23,000,State - MADHYA PRADESH,Urban,55-59,294735,126325,168410
C2308,23,000,State - MADHYA PRADESH,Urban,60-64,272644,138359,134285
C2308,23,000,State - MADHYA PRADESH,Urban,65-69,190369,105843,84526
C2308,23,000,State - MADHYA PRADESH,Urban,70-74,143569,90530,53039
C2308,23,000,State - MADHYA PRADESH,Urban,75-79,72211,44038,28173
C2308,23,000,State - MADHYA PRADESH,Urban,80+,98719,63811,34908
C2308,23,000,State - MADHYA PRADESH,Urban,Age not stated,17051,5483,11568
C2308,24,000,State - GUJARAT,Total,All ages,28948432,11329947,17618485
C2308,24,000,State - GUJARAT,Total,0-6,3661878,3661878,0
C2308,24,000,State - GUJARAT,Total,7,563579,122980,440599
C2308,24,000,State - GUJARAT,Total,8,548875,60295,488580
C2308,24,000,State - GUJARAT,Total,9,523545,40223,483322
C2308,24,000,State - GUJARAT,Total,10,607854,50126,557728
C2308,24,000,State - GUJARAT,Total,11,573045,35784,537261
C2308,24,000,State - GUJARAT,Total,12,581622,41262,540360
C2308,24,000,State - GUJARAT,Total,13,553513,37444,516069
C2308,24,000,State - GUJARAT,Total,14,549577,41282,508295
C2308,24,000,State - GUJARAT,Total,15,565087,54266,510821
C2308,24,000,State - GUJARAT,Total,16,535426,52004,483422
C2308,24,000,State - GUJARAT,Total,17,508548,50294,458254
C2308,24,000,State - GUJARAT,Total,18,595128,81050,514078
C2308,24,000,State - GUJARAT,Total,19,515461,69088,446373
C2308,24,000,State - GUJARAT,Total,20-24,2734595,511515,2223080
C2308,24,000,State - GUJARAT,Total,25-29,2511539,597655,1913884
C2308,24,000,State - GUJARAT,Total,30-34,2303504,688331,1615173
C2308,24,000,State - GUJARAT,Total,35-39,2082890,747563,1335327
C2308,24,000,State - GUJARAT,Total,40-44,1871600,786316,1085284
C2308,24,000,State - GUJARAT,Total,45-49,1602141,740448,861693
C2308,24,000,State - GUJARAT,Total,50-54,1287910,644380,643530
C2308,24,000,State - GUJARAT,Total,55-59,1016859,541240,475619
C2308,24,000,State - GUJARAT,Total,60-64,876493,526512,349981
C2308,24,000,State - GUJARAT,Total,65-69,620070,396949,223121
C2308,24,000,State - GUJARAT,Total,70-74,482155,328784,153371
C2308,24,000,State - GUJARAT,Total,75-79,243655,161608,82047
C2308,24,000,State - GUJARAT,Total,80+,318585,222417,96168
C2308,24,000,State - GUJARAT,Total,Age not stated,113298,38253,75045
C2308,24,000,State - GUJARAT,Rural,All ages,16895450,7942251,8953199
C2308,24,000,State - GUJARAT,Rural,0-6,2303448,2303448,0
C2308,24,000,State - GUJARAT,Rural,7,351222,81673,269549
C2308,24,000,State - GUJARAT,Rural,8,350894,40713,310181
C2308,24,000,State - GUJARAT,Rural,9,333050,26560,306490
C2308,24,000,State - GUJARAT,Rural,10,384992,32971,352021
C2308,24,000,State - GUJARAT,Rural,11,360420,23804,336616
C2308,24,000,State - GUJARAT,Rural,12,368195,28417,339778
C2308,24,000,State - GUJARAT,Rural,13,345950,26103,319847
C2308,24,000,State - GUJARAT,Rural,14,338945,29077,309868
C2308,24,000,State - GUJARAT,Rural,15,349155,37989,311166
C2308,24,000,State - GUJARAT,Rural,16,325478,37192,288286
C2308,24,000,State - GUJARAT,Rural,17,301917,35803,266114
C2308,24,000,State - GUJARAT,Rural,18,354512,59203,295309
C2308,24,000,State - GUJARAT,Rural,19,293898,49383,244515
C2308,24,000,State - GUJARAT,Rural,20-24,1515353,368819,1146534
C2308,24,000,State - GUJARAT,Rural,25-29,1328138,432155,895983
C2308,24,000,State - GUJARAT,Rural,30-34,1258397,508261,750136
C2308,24,000,State - GUJARAT,Rural,35-39,1149061,553263,595798
C2308,24,000,State - GUJARAT,Rural,40-44,1052829,585661,467168
C2308,24,000,State - GUJARAT,Rural,45-49,891708,549746,341962
C2308,24,000,State - GUJARAT,Rural,50-54,732093,482819,249274
C2308,24,000,State - GUJARAT,Rural,55-59,592318,411286,181032
C2308,24,000,State - GUJARAT,Rural,60-64,528694,394250,134444
C2308,24,000,State - GUJARAT,Rural,65-69,383659,297928,85731
C2308,24,000,State - GUJARAT,Rural,70-74,303123,244621,58502
C2308,24,000,State - GUJARAT,Rural,75-79,148461,119889,28572
C2308,24,000,State - GUJARAT,Rural,80+,193131,157645,35486
C2308,24,000,State - GUJARAT,Rural,Age not stated,56409,23572,32837
C2308,24,000,State - GUJARAT,Urban,All ages,12052982,3387696,8665286
C2308,24,000,State - GUJARAT,Urban,0-6,1358430,1358430,0
C2308,24,000,State - GUJARAT,Urban,7,212357,41307,171050
C2308,24,000,State - GUJARAT,Urban,8,197981,19582,178399
C2308,24,000,State - GUJARAT,Urban,9,190495,13663,176832
C2308,24,000,State - GUJARAT,Urban,10,222862,17155,205707
C2308,24,000,State - GUJARAT,Urban,11,212625,11980,200645
C2308,24,000,State - GUJARAT,Urban,12,213427,12845,200582
C2308,24,000,State - GUJARAT,Urban,13,207563,11341,196222
C2308,24,000,State - GUJARAT,Urban,14,210632,12205,198427
C2308,24,000,State - GUJARAT,Urban,15,215932,16277,199655
C2308,24,000,State - GUJARAT,Urban,16,209948,14812,195136
C2308,24,000,State - GUJARAT,Urban,17,206631,14491,192140
C2308,24,000,State - GUJARAT,Urban,18,240616,21847,218769
C2308,24,000,State - GUJARAT,Urban,19,221563,19705,201858
C2308,24,000,State - GUJARAT,Urban,20-24,1219242,142696,1076546
C2308,24,000,State - GUJARAT,Urban,25-29,1183401,165500,1017901
C2308,24,000,State - GUJARAT,Urban,30-34,1045107,180070,865037
C2308,24,000,State - GUJARAT,Urban,35-39,933829,194300,739529
C2308,24,000,State - GUJARAT,Urban,40-44,818771,200655,618116
C2308,24,000,State - GUJARAT,Urban,45-49,710433,190702,519731
C2308,24,000,State - GUJARAT,Urban,50-54,555817,161561,394256
C2308,24,000,State - GUJARAT,Urban,55-59,424541,129954,294587
C2308,24,000,State - GUJARAT,Urban,60-64,347799,132262,215537
C2308,24,000,State - GUJARAT,Urban,65-69,236411,99021,137390
C2308,24,000,State - GUJARAT,Urban,70-74,179032,84163,94869
C2308,24,000,State - GUJARAT,Urban,75-79,95194,41719,53475
C2308,24,000,State - GUJARAT,Urban,80+,125454,64772,60682
C2308,24,000,State - GUJARAT,Urban,Age not stated,56889,14681,42208
C2308,25,000,State - DAMAN & DIU,Total,All ages,92946,29183,63763
C2308,25,000,State - DAMAN & DIU,Total,0-6,12790,12790,0
C2308,25,000,State - DAMAN & DIU,Total,7,1772,313,1459
C2308,25,000,State - DAMAN & DIU,Total,8,1714,128,1586
C2308,25,000,State - DAMAN & DIU,Total,9,1540,75,1465
C2308,25,000,State - DAMAN & DIU,Total,10,1750,95,1655
C2308,25,000,State - DAMAN & DIU,Total,11,1657,66,1591
C2308,25,000,State - DAMAN & DIU,Total,12,1560,47,1513
C2308,25,000,State - DAMAN & DIU,Total,13,1542,34,1508
C2308,25,000,State - DAMAN & DIU,Total,14,1512,50,1462
C2308,25,000,State - DAMAN & DIU,Total,15,1482,59,1423
C2308,25,000,State - DAMAN & DIU,Total,16,1455,63,1392
C2308,25,000,State - DAMAN & DIU,Total,17,1463,67,1396
C2308,25,000,State - DAMAN & DIU,Total,18,1822,135,1687
C2308,25,000,State - DAMAN & DIU,Total,19,1853,126,1727
C2308,25,000,State - DAMAN & DIU,Total,20-24,10659,1229,9430
C2308,25,000,State - DAMAN & DIU,Total,25-29,11137,1673,9464
C2308,25,000,State - DAMAN & DIU,Total,30-34,8717,1536,7181
C2308,25,000,State - DAMAN & DIU,Total,35-39,7295,1607,5688
C2308,25,000,State - DAMAN & DIU,Total,40-44,5217,1393,3824
C2308,25,000,State - DAMAN & DIU,Total,45-49,3969,1331,2638
C2308,25,000,State - DAMAN & DIU,Total,50-54,2964,1176,1788
C2308,25,000,State - DAMAN & DIU,Total,55-59,2480,1092,1388
C2308,25,000,State - DAMAN & DIU,Total,60-64,2331,1292,1039
C2308,25,000,State - DAMAN & DIU,Total,65-69,1571,962,609
C2308,25,000,State - DAMAN & DIU,Total,70-74,1262,859,403
C2308,25,000,State - DAMAN & DIU,Total,75-79,630,444,186
C2308,25,000,State - DAMAN & DIU,Total,80+,694,510,184
C2308,25,000,State - DAMAN & DIU,Total,Age not stated,108,31,77
C2308,25,000,State - DAMAN & DIU,Rural,All ages,28001,10441,17560
C2308,25,000,State - DAMAN & DIU,Rural,0-6,3589,3589,0
C2308,25,000,State - DAMAN & DIU,Rural,7,554,82,472
C2308,25,000,State - DAMAN & DIU,Rural,8,574,24,550
C2308,25,000,State - DAMAN & DIU,Rural,9,550,10,540
C2308,25,000,State - DAMAN & DIU,Rural,10,653,15,638
C2308,25,000,State - DAMAN & DIU,Rural,11,608,11,597
C2308,25,000,State - DAMAN & DIU,Rural,12,591,9,582
C2308,25,000,State - DAMAN & DIU,Rural,13,611,7,604
C2308,25,000,State - DAMAN & DIU,Rural,14,570,8,562
C2308,25,000,State - DAMAN & DIU,Rural,15,562,9,553
C2308,25,000,State - DAMAN & DIU,Rural,16,537,8,529
C2308,25,000,State - DAMAN & DIU,Rural,17,589,11,578
C2308,25,000,State - DAMAN & DIU,Rural,18,576,16,560
C2308,25,000,State - DAMAN & DIU,Rural,19,625,27,598
C2308,25,000,State - DAMAN & DIU,Rural,20-24,2907,265,2642
C2308,25,000,State - DAMAN & DIU,Rural,25-29,2709,425,2284
C2308,25,000,State - DAMAN & DIU,Rural,30-34,2254,588,1666
C2308,25,000,State - DAMAN & DIU,Rural,35-39,2080,811,1269
C2308,25,000,State - DAMAN & DIU,Rural,40-44,1584,759,825
C2308,25,000,State - DAMAN & DIU,Rural,45-49,1270,719,551
C2308,25,000,State - DAMAN & DIU,Rural,50-54,1043,672,371
C2308,25,000,State - DAMAN & DIU,Rural,55-59,807,597,210
C2308,25,000,State - DAMAN & DIU,Rural,60-64,796,636,160
C2308,25,000,State - DAMAN & DIU,Rural,65-69,496,408,88
C2308,25,000,State - DAMAN & DIU,Rural,70-74,400,348,52
C2308,25,000,State - DAMAN & DIU,Rural,75-79,202,182,20
C2308,25,000,State - DAMAN & DIU,Rural,80+,224,191,33
C2308,25,000,State - DAMAN & DIU,Rural,Age not stated,40,14,26
C2308,25,000,State - DAMAN & DIU,Urban,All ages,64945,18742,46203
C2308,25,000,State - DAMAN & DIU,Urban,0-6,9201,9201,0
C2308,25,000,State - DAMAN & DIU,Urban,7,1218,231,987
C2308,25,000,State - DAMAN & DIU,Urban,8,1140,104,1036
C2308,25,000,State - DAMAN & DIU,Urban,9,990,65,925
C2308,25,000,State - DAMAN & DIU,Urban,10,1097,80,1017
C2308,25,000,State - DAMAN & DIU,Urban,11,1049,55,994
C2308,25,000,State - DAMAN & DIU,Urban,12,969,38,931
C2308,25,000,State - DAMAN & DIU,Urban,13,931,27,904
C2308,25,000,State - DAMAN & DIU,Urban,14,942,42,900
C2308,25,000,State - DAMAN & DIU,Urban,15,920,50,870
C2308,25,000,State - DAMAN & DIU,Urban,16,918,55,863
C2308,25,000,State - DAMAN & DIU,Urban,17,874,56,818
C2308,25,000,State - DAMAN & DIU,Urban,18,1246,119,1127
C2308,25,000,State - DAMAN & DIU,Urban,19,1228,99,1129
C2308,25,000,State - DAMAN & DIU,Urban,20-24,7752,964,6788
C2308,25,000,State - DAMAN & DIU,Urban,25-29,8428,1248,7180
C2308,25,000,State - DAMAN & DIU,Urban,30-34,6463,948,5515
C2308,25,000,State - DAMAN & DIU,Urban,35-39,5215,796,4419
C2308,25,000,State - DAMAN & DIU,Urban,40-44,3633,634,2999
C2308,25,000,State - DAMAN & DIU,Urban,45-49,2699,612,2087
C2308,25,000,State - DAMAN & DIU,Urban,50-54,1921,504,1417
C2308,25,000,State - DAMAN & DIU,Urban,55-59,1673,495,1178
C2308,25,000,State - DAMAN & DIU,Urban,60-64,1535,656,879
C2308,25,000,State - DAMAN & DIU,Urban,65-69,1075,554,521
C2308,25,000,State - DAMAN & DIU,Urban,70-74,862,511,351
C2308,25,000,State - DAMAN & DIU,Urban,75-79,428,262,166
C2308,25,000,State - DAMAN & DIU,Urban,80+,470,319,151
C2308,25,000,State - DAMAN & DIU,Urban,Age not stated,68,17,51
C2308,26,000,State - DADRA & NAGAR HAVELI,Total,All ages,149949,69240,80709
C2308,26,000,State - DADRA & NAGAR HAVELI,Total,0-6,24464,24464,0
C2308,26,000,State - DADRA & NAGAR HAVELI,Total,7,3516,584,2932
C2308,26,000,State - DADRA & NAGAR HAVELI,Total,8,3577,251,3326
C2308,26,000,State - DADRA & NAGAR HAVELI,Total,9,3292,189,3103
C2308,26,000,State - DADRA & NAGAR HAVELI,Total,10,3784,245,3539
C2308,26,000,State - DADRA & NAGAR HAVELI,Total,11,3502,163,3339
C2308,26,000,State - DADRA & NAGAR HAVELI,Total,12,3294,212,3082
C2308,26,000,State - DADRA & NAGAR HAVELI,Total,13,3155,205,2950
C2308,26,000,State - DADRA & NAGAR HAVELI,Total,14,2883,242,2641
C2308,26,000,State - DADRA & NAGAR HAVELI,Total,15,2768,322,2446
C2308,26,000,State - DADRA & NAGAR HAVELI,Total,16,2578,421,2157
C2308,26,000,State - DADRA & NAGAR HAVELI,Total,17,2296,386,1910
C2308,26,000,State - DADRA & NAGAR HAVELI,Total,18,2857,660,2197
C2308,26,000,State - DADRA & NAGAR HAVELI,Total,19,2626,563,2063
C2308,26,000,State - DADRA & NAGAR HAVELI,Total,20-24,16706,4702,12004
C2308,26,000,State - DADRA & NAGAR HAVELI,Total,25-29,16389,5344,11045
C2308,26,000,State - DADRA & NAGAR HAVELI,Total,30-34,12684,4855,7829
C2308,26,000,State - DADRA & NAGAR HAVELI,Total,35-39,10415,4897,5518
C2308,26,000,State - DADRA & NAGAR HAVELI,Total,40-44,7627,4593,3034
C2308,26,000,State - DADRA & NAGAR HAVELI,Total,45-49,6118,4082,2036
C2308,26,000,State - DADRA & NAGAR HAVELI,Total,50-54,4288,3060,1228
C2308,26,000,State - DADRA & NAGAR HAVELI,Total,55-59,3425,2569,856
C2308,26,000,State - DADRA & NAGAR HAVELI,Total,60-64,3037,2456,581
C2308,26,000,State - DADRA & NAGAR HAVELI,Total,65-69,1961,1605,356
C2308,26,000,State - DADRA & NAGAR HAVELI,Total,70-74,1336,1160,176
C2308,26,000,State - DADRA & NAGAR HAVELI,Total,75-79,564,454,110
C2308,26,000,State - DADRA & NAGAR HAVELI,Total,80+,635,473,162
C2308,26,000,State - DADRA & NAGAR HAVELI,Total,Age not stated,172,83,89
C2308,26,000,State - DADRA & NAGAR HAVELI,Rural,All ages,84809,49717,35092
C2308,26,000,State - DADRA & NAGAR HAVELI,Rural,0-6,14037,14037,0
C2308,26,000,State - DADRA & NAGAR HAVELI,Rural,7,2063,341,1722
C2308,26,000,State - DADRA & NAGAR HAVELI,Rural,8,2234,161,2073
C2308,26,000,State - DADRA & NAGAR HAVELI,Rural,9,2103,131,1972
C2308,26,000,State - DADRA & NAGAR HAVELI,Rural,10,2406,175,2231
C2308,26,000,State - DADRA & NAGAR HAVELI,Rural,11,2303,126,2177
C2308,26,000,State - DADRA & NAGAR HAVELI,Rural,12,2155,178,1977
C2308,26,000,State - DADRA & NAGAR HAVELI,Rural,13,2092,178,1914
C2308,26,000,State - DADRA & NAGAR HAVELI,Rural,14,1832,204,1628
C2308,26,000,State - DADRA & NAGAR HAVELI,Rural,15,1793,290,1503
C2308,26,000,State - DADRA & NAGAR HAVELI,Rural,16,1677,380,1297
C2308,26,000,State - DADRA & NAGAR HAVELI,Rural,17,1405,350,1055
C2308,26,000,State - DADRA & NAGAR HAVELI,Rural,18,1795,589,1206
C2308,26,000,State - DADRA & NAGAR HAVELI,Rural,19,1568,473,1095
C2308,26,000,State - DADRA & NAGAR HAVELI,Rural,20-24,8866,3942,4924
C2308,26,000,State - DADRA & NAGAR HAVELI,Rural,25-29,7402,4169,3233
C2308,26,000,State - DADRA & NAGAR HAVELI,Rural,30-34,5778,3800,1978
C2308,26,000,State - DADRA & NAGAR HAVELI,Rural,35-39,5229,3968,1261
C2308,26,000,State - DADRA & NAGAR HAVELI,Rural,40-44,4415,3710,705
C2308,26,000,State - DADRA & NAGAR HAVELI,Rural,45-49,3772,3313,459
C2308,26,000,State - DADRA & NAGAR HAVELI,Rural,50-54,2714,2472,242
C2308,26,000,State - DADRA & NAGAR HAVELI,Rural,55-59,2175,2003,172
C2308,26,000,State - DADRA & NAGAR HAVELI,Rural,60-64,2026,1927,99
C2308,26,000,State - DADRA & NAGAR HAVELI,Rural,65-69,1294,1221,73
C2308,26,000,State - DADRA & NAGAR HAVELI,Rural,70-74,898,883,15
C2308,26,000,State - DADRA & NAGAR HAVELI,Rural,75-79,351,333,18
C2308,26,000,State - DADRA & NAGAR HAVELI,Rural,80+,319,297,22
C2308,26,000,State - DADRA & NAGAR HAVELI,Rural,Age not stated,107,66,41
C2308,26,000,State - DADRA & NAGAR HAVELI,Urban,All ages,65140,19523,45617
C2308,26,000,State - DADRA & NAGAR HAVELI,Urban,0-6,10427,10427,0
C2308,26,000,State - DADRA & NAGAR HAVELI,Urban,7,1453,243,1210
C2308,26,000,State - DADRA & NAGAR HAVELI,Urban,8,1343,90,1253
C2308,26,000,State - DADRA & NAGAR HAVELI,Urban,9,1189,58,1131
C2308,26,000,State - DADRA & NAGAR HAVELI,Urban,10,1378,70,1308
C2308,26,000,State - DADRA & NAGAR HAVELI,Urban,11,1199,37,1162
C2308,26,000,State - DADRA & NAGAR HAVELI,Urban,12,1139,34,1105
C2308,26,000,State - DADRA & NAGAR HAVELI,Urban,13,1063,27,1036
C2308,26,000,State - DADRA & NAGAR HAVELI,Urban,14,1051,38,1013
C2308,26,000,State - DADRA & NAGAR HAVELI,Urban,15,975,32,943
C2308,26,000,State - DADRA & NAGAR HAVELI,Urban,16,901,41,860
C2308,26,000,State - DADRA & NAGAR HAVELI,Urban,17,891,36,855
C2308,26,000,State - DADRA & NAGAR HAVELI,Urban,18,1062,71,991
C2308,26,000,State - DADRA & NAGAR HAVELI,Urban,19,1058,90,968
C2308,26,000,State - DADRA & NAGAR HAVELI,Urban,20-24,7840,760,7080
C2308,26,000,State - DADRA & NAGAR HAVELI,Urban,25-29,8987,1175,7812
C2308,26,000,State - DADRA & NAGAR HAVELI,Urban,30-34,6906,1055,5851
C2308,26,000,State - DADRA & NAGAR HAVELI,Urban,35-39,5186,929,4257
C2308,26,000,State - DADRA & NAGAR HAVELI,Urban,40-44,3212,883,2329
C2308,26,000,State - DADRA & NAGAR HAVELI,Urban,45-49,2346,769,1577
C2308,26,000,State - DADRA & NAGAR HAVELI,Urban,50-54,1574,588,986
C2308,26,000,State - DADRA & NAGAR HAVELI,Urban,55-59,1250,566,684
C2308,26,000,State - DADRA & NAGAR HAVELI,Urban,60-64,1011,529,482
C2308,26,000,State - DADRA & NAGAR HAVELI,Urban,65-69,667,384,283
C2308,26,000,State - DADRA & NAGAR HAVELI,Urban,70-74,438,277,161
C2308,26,000,State - DADRA & NAGAR HAVELI,Urban,75-79,213,121,92
C2308,26,000,State - DADRA & NAGAR HAVELI,Urban,80+,316,176,140
C2308,26,000,State - DADRA & NAGAR HAVELI,Urban,Age not stated,65,17,48
C2308,27,000,State - MAHARASHTRA,Total,All ages,54131277,17834571,36296706
C2308,27,000,State - MAHARASHTRA,Total,0-6,6291126,6291126,0
C2308,27,000,State - MAHARASHTRA,Total,7,934275,211193,723082
C2308,27,000,State - MAHARASHTRA,Total,8,916229,81543,834686
C2308,27,000,State - MAHARASHTRA,Total,9,923244,54502,868742
C2308,27,000,State - MAHARASHTRA,Total,10,1089893,72029,1017864
C2308,27,000,State - MAHARASHTRA,Total,11,1022179,45861,976318
C2308,27,000,State - MAHARASHTRA,Total,12,989718,45475,944243
C2308,27,000,State - MAHARASHTRA,Total,13,986070,39862,946208
C2308,27,000,State - MAHARASHTRA,Total,14,984414,43269,941145
C2308,27,000,State - MAHARASHTRA,Total,15,990737,53816,936921
C2308,27,000,State - MAHARASHTRA,Total,16,970447,50414,920033
C2308,27,000,State - MAHARASHTRA,Total,17,913506,46239,867267
C2308,27,000,State - MAHARASHTRA,Total,18,1080629,75793,1004836
C2308,27,000,State - MAHARASHTRA,Total,19,961548,65808,895740
C2308,27,000,State - MAHARASHTRA,Total,20-24,5245852,507461,4738391
C2308,27,000,State - MAHARASHTRA,Total,25-29,4874553,662671,4211882
C2308,27,000,State - MAHARASHTRA,Total,30-34,4260010,814184,3445826
C2308,27,000,State - MAHARASHTRA,Total,35-39,4037726,1032156,3005570
C2308,27,000,State - MAHARASHTRA,Total,40-44,3451264,1103811,2347453
C2308,27,000,State - MAHARASHTRA,Total,45-49,2916236,1070949,1845287
C2308,27,000,State - MAHARASHTRA,Total,50-54,2338326,945186,1393140
C2308,27,000,State - MAHARASHTRA,Total,55-59,1911685,856456,1055229
C2308,27,000,State - MAHARASHTRA,Total,60-64,1925841,1065316,860525
C2308,27,000,State - MAHARASHTRA,Total,65-69,1638114,1018449,619665
C2308,27,000,State - MAHARASHTRA,Total,70-74,1103844,742334,361510
C2308,27,000,State - MAHARASHTRA,Total,75-79,547342,357121,190221
C2308,27,000,State - MAHARASHTRA,Total,80+,638085,423299,214786
C2308,27,000,State - MAHARASHTRA,Total,Age not stated,188384,58248,130136
C2308,27,000,State - MAHARASHTRA,Rural,All ages,30017040,11925754,18091286
C2308,27,000,State - MAHARASHTRA,Rural,0-6,3621555,3621555,0
C2308,27,000,State - MAHARASHTRA,Rural,7,528061,130450,397611
C2308,27,000,State - MAHARASHTRA,Rural,8,533859,50404,483455
C2308,27,000,State - MAHARASHTRA,Rural,9,544709,33138,511571
C2308,27,000,State - MAHARASHTRA,Rural,10,636852,43781,593071
C2308,27,000,State - MAHARASHTRA,Rural,11,598719,28476,570243
C2308,27,000,State - MAHARASHTRA,Rural,12,579441,29939,549502
C2308,27,000,State - MAHARASHTRA,Rural,13,577850,26112,551738
C2308,27,000,State - MAHARASHTRA,Rural,14,575039,28883,546156
C2308,27,000,State - MAHARASHTRA,Rural,15,576384,36353,540031
C2308,27,000,State - MAHARASHTRA,Rural,16,563090,34112,528978
C2308,27,000,State - MAHARASHTRA,Rural,17,510378,30228,480150
C2308,27,000,State - MAHARASHTRA,Rural,18,601376,51141,550235
C2308,27,000,State - MAHARASHTRA,Rural,19,519213,43696,475517
C2308,27,000,State - MAHARASHTRA,Rural,20-24,2746645,335897,2410748
C2308,27,000,State - MAHARASHTRA,Rural,25-29,2435926,435512,2000414
C2308,27,000,State - MAHARASHTRA,Rural,30-34,2176444,559118,1617326
C2308,27,000,State - MAHARASHTRA,Rural,35-39,2112082,724363,1387719
C2308,27,000,State - MAHARASHTRA,Rural,40-44,1838649,792591,1046058
C2308,27,000,State - MAHARASHTRA,Rural,45-49,1559955,769897,790058
C2308,27,000,State - MAHARASHTRA,Rural,50-54,1274882,687709,587173
C2308,27,000,State - MAHARASHTRA,Rural,55-59,1078277,641102,437175
C2308,27,000,State - MAHARASHTRA,Rural,60-64,1184588,808865,375723
C2308,27,000,State - MAHARASHTRA,Rural,65-69,1088768,799143,289625
C2308,27,000,State - MAHARASHTRA,Rural,70-74,726447,570707,155740
C2308,27,000,State - MAHARASHTRA,Rural,75-79,340552,270109,70443
C2308,27,000,State - MAHARASHTRA,Rural,80+,390093,305980,84113
C2308,27,000,State - MAHARASHTRA,Rural,Age not stated,97206,36493,60713
C2308,27,000,State - MAHARASHTRA,Urban,All ages,24114237,5908817,18205420
C2308,27,000,State - MAHARASHTRA,Urban,0-6,2669571,2669571,0
C2308,27,000,State - MAHARASHTRA,Urban,7,406214,80743,325471
C2308,27,000,State - MAHARASHTRA,Urban,8,382370,31139,351231
C2308,27,000,State - MAHARASHTRA,Urban,9,378535,21364,357171
C2308,27,000,State - MAHARASHTRA,Urban,10,453041,28248,424793
C2308,27,000,State - MAHARASHTRA,Urban,11,423460,17385,406075
C2308,27,000,State - MAHARASHTRA,Urban,12,410277,15536,394741
C2308,27,000,State - MAHARASHTRA,Urban,13,408220,13750,394470
C2308,27,000,State - MAHARASHTRA,Urban,14,409375,14386,394989
C2308,27,000,State - MAHARASHTRA,Urban,15,414353,17463,396890
C2308,27,000,State - MAHARASHTRA,Urban,16,407357,16302,391055
C2308,27,000,State - MAHARASHTRA,Urban,17,403128,16011,387117
C2308,27,000,State - MAHARASHTRA,Urban,18,479253,24652,454601
C2308,27,000,State - MAHARASHTRA,Urban,19,442335,22112,420223
C2308,27,000,State - MAHARASHTRA,Urban,20-24,2499207,171564,2327643
C2308,27,000,State - MAHARASHTRA,Urban,25-29,2438627,227159,2211468
C2308,27,000,State - MAHARASHTRA,Urban,30-34,2083566,255066,1828500
C2308,27,000,State - MAHARASHTRA,Urban,35-39,1925644,307793,1617851
C2308,27,000,State - MAHARASHTRA,Urban,40-44,1612615,311220,1301395
C2308,27,000,State - MAHARASHTRA,Urban,45-49,1356281,301052,1055229
C2308,27,000,State - MAHARASHTRA,Urban,50-54,1063444,257477,805967
C2308,27,000,State - MAHARASHTRA,Urban,55-59,833408,215354,618054
C2308,27,000,State - MAHARASHTRA,Urban,60-64,741253,256451,484802
C2308,27,000,State - MAHARASHTRA,Urban,65-69,549346,219306,330040
C2308,27,000,State - MAHARASHTRA,Urban,70-74,377397,171627,205770
C2308,27,000,State - MAHARASHTRA,Urban,75-79,206790,87012,119778
C2308,27,000,State - MAHARASHTRA,Urban,80+,247992,117319,130673
C2308,27,000,State - MAHARASHTRA,Urban,Age not stated,91178,21755,69423
C2308,28,000,State - ANDHRA PRADESH,Total,All ages,42138631,19833114,22305517
C2308,28,000,State - ANDHRA PRADESH,Total,0-6,4427852,4427852,0
C2308,28,000,State - ANDHRA PRADESH,Total,7,719040,195022,524018
C2308,28,000,State - ANDHRA PRADESH,Total,8,730609,92694,637915
C2308,28,000,State - ANDHRA PRADESH,Total,9,715411,58189,657222
C2308,28,000,State - ANDHRA PRADESH,Total,10,854308,65891,788417
C2308,28,000,State - ANDHRA PRADESH,Total,11,764103,44164,719939
C2308,28,000,State - ANDHRA PRADESH,Total,12,816378,53082,763296
C2308,28,000,State - ANDHRA PRADESH,Total,13,776327,46533,729794
C2308,28,000,State - ANDHRA PRADESH,Total,14,781595,53468,728127
C2308,28,000,State - ANDHRA PRADESH,Total,15,790809,67771,723038
C2308,28,000,State - ANDHRA PRADESH,Total,16,752131,65077,687054
C2308,28,000,State - ANDHRA PRADESH,Total,17,685119,60052,625067
C2308,28,000,State - ANDHRA PRADESH,Total,18,916244,128720,787524
C2308,28,000,State - ANDHRA PRADESH,Total,19,753137,108444,644693
C2308,28,000,State - ANDHRA PRADESH,Total,20-24,4076397,913446,3162951
C2308,28,000,State - ANDHRA PRADESH,Total,25-29,3989149,1357493,2631656
C2308,28,000,State - ANDHRA PRADESH,Total,30-34,3283964,1407706,1876258
C2308,28,000,State - ANDHRA PRADESH,Total,35-39,3308827,1730421,1578406
C2308,28,000,State - ANDHRA PRADESH,Total,40-44,2605075,1543260,1061815
C2308,28,000,State - ANDHRA PRADESH,Total,45-49,2282636,1460813,821823
C2308,28,000,State - ANDHRA PRADESH,Total,50-54,1794803,1218879,575924
C2308,28,000,State - ANDHRA PRADESH,Total,55-59,1559059,1110458,448601
C2308,28,000,State - ANDHRA PRADESH,Total,60-64,1714073,1337485,376588
C2308,28,000,State - ANDHRA PRADESH,Total,65-69,1133494,902551,230943
C2308,28,000,State - ANDHRA PRADESH,Total,70-74,766615,632669,133946
C2308,28,000,State - ANDHRA PRADESH,Total,75-79,329515,262315,67200
C2308,28,000,State - ANDHRA PRADESH,Total,80+,428216,337339,90877
C2308,28,000,State - ANDHRA PRADESH,Total,Age not stated,383745,151320,232425
C2308,28,000,State - ANDHRA PRADESH,Rural,All ages,28118461,15162996,12955465
C2308,28,000,State - ANDHRA PRADESH,Rural,0-6,2982734,2982734,0
C2308,28,000,State - ANDHRA PRADESH,Rural,7,489249,143188,346061
C2308,28,000,State - ANDHRA PRADESH,Rural,8,504390,67561,436829
C2308,28,000,State - ANDHRA PRADESH,Rural,9,487956,41071,446885
C2308,28,000,State - ANDHRA PRADESH,Rural,10,579864,47138,532726
C2308,28,000,State - ANDHRA PRADESH,Rural,11,510562,30834,479728
C2308,28,000,State - ANDHRA PRADESH,Rural,12,558680,40355,518325
C2308,28,000,State - ANDHRA PRADESH,Rural,13,527710,34954,492756
C2308,28,000,State - ANDHRA PRADESH,Rural,14,528726,40850,487876
C2308,28,000,State - ANDHRA PRADESH,Rural,15,526347,52380,473967
C2308,28,000,State - ANDHRA PRADESH,Rural,16,487688,49997,437691
C2308,28,000,State - ANDHRA PRADESH,Rural,17,432256,44910,387346
C2308,28,000,State - ANDHRA PRADESH,Rural,18,610683,102346,508337
C2308,28,000,State - ANDHRA PRADESH,Rural,19,477102,83237,393865
C2308,28,000,State - ANDHRA PRADESH,Rural,20-24,2580607,717214,1863393
C2308,28,000,State - ANDHRA PRADESH,Rural,25-29,2542439,1078535,1463904
C2308,28,000,State - ANDHRA PRADESH,Rural,30-34,2126704,1127495,999209
C2308,28,000,State - ANDHRA PRADESH,Rural,35-39,2181914,1371258,810656
C2308,28,000,State - ANDHRA PRADESH,Rural,40-44,1721080,1217519,503561
C2308,28,000,State - ANDHRA PRADESH,Rural,45-49,1517706,1141820,375886
C2308,28,000,State - ANDHRA PRADESH,Rural,50-54,1212242,957048,255194
C2308,28,000,State - ANDHRA PRADESH,Rural,55-59,1096785,890487,206298
C2308,28,000,State - ANDHRA PRADESH,Rural,60-64,1275689,1090326,185363
C2308,28,000,State - ANDHRA PRADESH,Rural,65-69,850523,736802,113721
C2308,28,000,State - ANDHRA PRADESH,Rural,70-74,574771,511275,63496
C2308,28,000,State - ANDHRA PRADESH,Rural,75-79,235745,205920,29825
C2308,28,000,State - ANDHRA PRADESH,Rural,80+,298485,258631,39854
C2308,28,000,State - ANDHRA PRADESH,Rural,Age not stated,199824,97111,102713
C2308,28,000,State - ANDHRA PRADESH,Urban,All ages,14020170,4670118,9350052
C2308,28,000,State - ANDHRA PRADESH,Urban,0-6,1445118,1445118,0
C2308,28,000,State - ANDHRA PRADESH,Urban,7,229791,51834,177957
C2308,28,000,State - ANDHRA PRADESH,Urban,8,226219,25133,201086
C2308,28,000,State - ANDHRA PRADESH,Urban,9,227455,17118,210337
C2308,28,000,State - ANDHRA PRADESH,Urban,10,274444,18753,255691
C2308,28,000,State - ANDHRA PRADESH,Urban,11,253541,13330,240211
C2308,28,000,State - ANDHRA PRADESH,Urban,12,257698,12727,244971
C2308,28,000,State - ANDHRA PRADESH,Urban,13,248617,11579,237038
C2308,28,000,State - ANDHRA PRADESH,Urban,14,252869,12618,240251
C2308,28,000,State - ANDHRA PRADESH,Urban,15,264462,15391,249071
C2308,28,000,State - ANDHRA PRADESH,Urban,16,264443,15080,249363
C2308,28,000,State - ANDHRA PRADESH,Urban,17,252863,15142,237721
C2308,28,000,State - ANDHRA PRADESH,Urban,18,305561,26374,279187
C2308,28,000,State - ANDHRA PRADESH,Urban,19,276035,25207,250828
C2308,28,000,State - ANDHRA PRADESH,Urban,20-24,1495790,196232,1299558
C2308,28,000,State - ANDHRA PRADESH,Urban,25-29,1446710,278958,1167752
C2308,28,000,State - ANDHRA PRADESH,Urban,30-34,1157260,280211,877049
C2308,28,000,State - ANDHRA PRADESH,Urban,35-39,1126913,359163,767750
C2308,28,000,State - ANDHRA PRADESH,Urban,40-44,883995,325741,558254
C2308,28,000,State - ANDHRA PRADESH,Urban,45-49,764930,318993,445937
C2308,28,000,State - ANDHRA PRADESH,Urban,50-54,582561,261831,320730
C2308,28,000,State - ANDHRA PRADESH,Urban,55-59,462274,219971,242303
C2308,28,000,State - ANDHRA PRADESH,Urban,60-64,438384,247159,191225
C2308,28,000,State - ANDHRA PRADESH,Urban,65-69,282971,165749,117222
C2308,28,000,State - ANDHRA PRADESH,Urban,70-74,191844,121394,70450
C2308,28,000,State - ANDHRA PRADESH,Urban,75-79,93770,56395,37375
C2308,28,000,State - ANDHRA PRADESH,Urban,80+,129731,78708,51023
C2308,28,000,State - ANDHRA PRADESH,Urban,Age not stated,183921,54209,129712
C2308,29,000,State - KARNATAKA,Total,All ages,30128640,11989789,18138851
C2308,29,000,State - KARNATAKA,Total,0-6,3485742,3485742,0
C2308,29,000,State - KARNATAKA,Total,7,495216,104866,390350
C2308,29,000,State - KARNATAKA,Total,8,514496,41654,472842
C2308,29,000,State - KARNATAKA,Total,9,514080,28206,485874
C2308,29,000,State - KARNATAKA,Total,10,594271,38764,555507
C2308,29,000,State - KARNATAKA,Total,11,549764,24883,524881
C2308,29,000,State - KARNATAKA,Total,12,563819,30646,533173
C2308,29,000,State - KARNATAKA,Total,13,529402,25645,503757
C2308,29,000,State - KARNATAKA,Total,14,544103,31035,513068
C2308,29,000,State - KARNATAKA,Total,15,543040,37378,505662
C2308,29,000,State - KARNATAKA,Total,16,536857,38138,498719
C2308,29,000,State - KARNATAKA,Total,17,496514,33262,463252
C2308,29,000,State - KARNATAKA,Total,18,656745,70459,586286
C2308,29,000,State - KARNATAKA,Total,19,552073,57763,494310
C2308,29,000,State - KARNATAKA,Total,20-24,2942972,434092,2508880
C2308,29,000,State - KARNATAKA,Total,25-29,2892352,643933,2248419
C2308,29,000,State - KARNATAKA,Total,30-34,2308786,682114,1626672
C2308,29,000,State - KARNATAKA,Total,35-39,2376363,935998,1440365
C2308,29,000,State - KARNATAKA,Total,40-44,1848944,852303,996641
C2308,29,000,State - KARNATAKA,Total,45-49,1714949,877668,837281
C2308,29,000,State - KARNATAKA,Total,50-54,1317301,725739,591562
C2308,29,000,State - KARNATAKA,Total,55-59,1086450,629834,456616
C2308,29,000,State - KARNATAKA,Total,60-64,1065422,713192,352230
C2308,29,000,State - KARNATAKA,Total,65-69,796432,560067,236365
C2308,29,000,State - KARNATAKA,Total,70-74,550706,411668,139038
C2308,29,000,State - KARNATAKA,Total,75-79,274592,198911,75681
C2308,29,000,State - KARNATAKA,Total,80+,356808,268595,88213
C2308,29,000,State - KARNATAKA,Total,Age not stated,20441,7234,13207
C2308,29,000,State - KARNATAKA,Rural,All ages,18539981,8784242,9755739
C2308,29,000,State - KARNATAKA,Rural,0-6,2200576,2200576,0
C2308,29,000,State - KARNATAKA,Rural,7,306820,71672,235148
C2308,29,000,State - KARNATAKA,Rural,8,326195,28836,297359
C2308,29,000,State - KARNATAKA,Rural,9,329010,19322,309688
C2308,29,000,State - KARNATAKA,Rural,10,378161,26658,351503
C2308,29,000,State - KARNATAKA,Rural,11,346695,17371,329324
C2308,29,000,State - KARNATAKA,Rural,12,361575,23226,338349
C2308,29,000,State - KARNATAKA,Rural,13,336785,19251,317534
C2308,29,000,State - KARNATAKA,Rural,14,349534,23870,325664
C2308,29,000,State - KARNATAKA,Rural,15,348411,28705,319706
C2308,29,000,State - KARNATAKA,Rural,16,340598,29867,310731
C2308,29,000,State - KARNATAKA,Rural,17,300432,24739,275693
C2308,29,000,State - KARNATAKA,Rural,18,409110,54660,354450
C2308,29,000,State - KARNATAKA,Rural,19,325904,43429,282475
C2308,29,000,State - KARNATAKA,Rural,20-24,1699841,328309,1371532
C2308,29,000,State - KARNATAKA,Rural,25-29,1638021,490649,1147372
C2308,29,000,State - KARNATAKA,Rural,30-34,1325352,528362,796990
C2308,29,000,State - KARNATAKA,Rural,35-39,1433319,726078,707241
C2308,29,000,State - KARNATAKA,Rural,40-44,1137021,668895,468126
C2308,29,000,State - KARNATAKA,Rural,45-49,1061765,680118,381647
C2308,29,000,State - KARNATAKA,Rural,50-54,821296,565284,256012
C2308,29,000,State - KARNATAKA,Rural,55-59,686748,492492,194256
C2308,29,000,State - KARNATAKA,Rural,60-64,709961,559212,150749
C2308,29,000,State - KARNATAKA,Rural,65-69,547638,442650,104988
C2308,29,000,State - KARNATAKA,Rural,70-74,383994,325758,58236
C2308,29,000,State - KARNATAKA,Rural,75-79,183775,154174,29601
C2308,29,000,State - KARNATAKA,Rural,80+,239568,205201,34367
C2308,29,000,State - KARNATAKA,Rural,Age not stated,11876,4878,6998
C2308,29,000,State - KARNATAKA,Urban,All ages,11588659,3205547,8383112
C2308,29,000,State - KARNATAKA,Urban,0-6,1285166,1285166,0
C2308,29,000,State - KARNATAKA,Urban,7,188396,33194,155202
C2308,29,000,State - KARNATAKA,Urban,8,188301,12818,175483
C2308,29,000,State - KARNATAKA,Urban,9,185070,8884,176186
C2308,29,000,State - KARNATAKA,Urban,10,216110,12106,204004
C2308,29,000,State - KARNATAKA,Urban,11,203069,7512,195557
C2308,29,000,State - KARNATAKA,Urban,12,202244,7420,194824
C2308,29,000,State - KARNATAKA,Urban,13,192617,6394,186223
C2308,29,000,State - KARNATAKA,Urban,14,194569,7165,187404
C2308,29,000,State - KARNATAKA,Urban,15,194629,8673,185956
C2308,29,000,State - KARNATAKA,Urban,16,196259,8271,187988
C2308,29,000,State - KARNATAKA,Urban,17,196082,8523,187559
C2308,29,000,State - KARNATAKA,Urban,18,247635,15799,231836
C2308,29,000,State - KARNATAKA,Urban,19,226169,14334,211835
C2308,29,000,State - KARNATAKA,Urban,20-24,1243131,105783,1137348
C2308,29,000,State - KARNATAKA,Urban,25-29,1254331,153284,1101047
C2308,29,000,State - KARNATAKA,Urban,30-34,983434,153752,829682
C2308,29,000,State - KARNATAKA,Urban,35-39,943044,209920,733124
C2308,29,000,State - KARNATAKA,Urban,40-44,711923,183408,528515
C2308,29,000,State - KARNATAKA,Urban,45-49,653184,197550,455634
C2308,29,000,State - KARNATAKA,Urban,50-54,496005,160455,335550
C2308,29,000,State - KARNATAKA,Urban,55-59,399702,137342,262360
C2308,29,000,State - KARNATAKA,Urban,60-64,355461,153980,201481
C2308,29,000,State - KARNATAKA,Urban,65-69,248794,117417,131377
C2308,29,000,State - KARNATAKA,Urban,70-74,166712,85910,80802
C2308,29,000,State - KARNATAKA,Urban,75-79,90817,44737,46080
C2308,29,000,State - KARNATAKA,Urban,80+,117240,63394,53846
C2308,29,000,State - KARNATAKA,Urban,Age not stated,8565,2356,6209
C2308,30,000,State - GOA,Total,All ages,719405,169741,549664
C2308,30,000,State - GOA,Total,0-6,70151,70151,0
C2308,30,000,State - GOA,Total,7,10297,1713,8584
C2308,30,000,State - GOA,Total,8,9746,575,9171
C2308,30,000,State - GOA,Total,9,10288,424,9864
C2308,30,000,State - GOA,Total,10,11499,479,11020
C2308,30,000,State - GOA,Total,11,11000,336,10664
C2308,30,000,State - GOA,Total,12,10163,268,9895
C2308,30,000,State - GOA,Total,13,10456,247,10209
C2308,30,000,State - GOA,Total,14,10454,251,10203
C2308,30,000,State - GOA,Total,15,10516,297,10219
C2308,30,000,State - GOA,Total,16,10036,269,9767
C2308,30,000,State - GOA,Total,17,10193,274,9919
C2308,30,000,State - GOA,Total,18,11513,454,11059
C2308,30,000,State - GOA,Total,19,11542,435,11107
C2308,30,000,State - GOA,Total,20-24,60129,3313,56816
C2308,30,000,State - GOA,Total,25-29,64882,4814,60068
C2308,30,000,State - GOA,Total,30-34,62388,5149,57239
C2308,30,000,State - GOA,Total,35-39,62757,6801,55956
C2308,30,000,State - GOA,Total,40-44,53008,7723,45285
C2308,30,000,State - GOA,Total,45-49,46869,8812,38057
C2308,30,000,State - GOA,Total,50-54,37810,8762,29048
C2308,30,000,State - GOA,Total,55-59,33532,9365,24167
C2308,30,000,State - GOA,Total,60-64,32004,12452,19552
C2308,30,000,State - GOA,Total,65-69,22014,9637,12377
C2308,30,000,State - GOA,Total,70-74,16165,7732,8433
C2308,30,000,State - GOA,Total,75-79,9308,4121,5187
C2308,30,000,State - GOA,Total,80+,9689,4629,5060
C2308,30,000,State - GOA,Total,Age not stated,996,258,738
C2308,30,000,State - GOA,Rural,All ages,276295,72167,204128
C2308,30,000,State - GOA,Rural,0-6,26242,26242,0
C2308,30,000,State - GOA,Rural,7,3853,645,3208
C2308,30,000,State - GOA,Rural,8,3647,190,3457
C2308,30,000,State - GOA,Rural,9,3864,120,3744
C2308,30,000,State - GOA,Rural,10,4425,139,4286
C2308,30,000,State - GOA,Rural,11,4215,102,4113
C2308,30,000,State - GOA,Rural,12,3786,86,3700
C2308,30,000,State - GOA,Rural,13,3924,84,3840
C2308,30,000,State - GOA,Rural,14,4012,90,3922
C2308,30,000,State - GOA,Rural,15,3990,89,3901
C2308,30,000,State - GOA,Rural,16,3783,85,3698
C2308,30,000,State - GOA,Rural,17,3913,86,3827
C2308,30,000,State - GOA,Rural,18,4301,149,4152
C2308,30,000,State - GOA,Rural,19,4384,151,4233
C2308,30,000,State - GOA,Rural,20-24,22700,1058,21642
C2308,30,000,State - GOA,Rural,25-29,24667,1610,23057
C2308,30,000,State - GOA,Rural,30-34,24054,1889,22165
C2308,30,000,State - GOA,Rural,35-39,24118,2847,21271
C2308,30,000,State - GOA,Rural,40-44,19820,3522,16298
C2308,30,000,State - GOA,Rural,45-49,17813,4312,13501
C2308,30,000,State - GOA,Rural,50-54,14609,4411,10198
C2308,30,000,State - GOA,Rural,55-59,13040,4766,8274
C2308,30,000,State - GOA,Rural,60-64,13016,6324,6692
C2308,30,000,State - GOA,Rural,65-69,9263,4909,4354
C2308,30,000,State - GOA,Rural,70-74,6809,3941,2868
C2308,30,000,State - GOA,Rural,75-79,3694,2027,1667
C2308,30,000,State - GOA,Rural,80+,3919,2180,1739
C2308,30,000,State - GOA,Rural,Age not stated,434,113,321
C2308,30,000,State - GOA,Urban,All ages,443110,97574,345536
C2308,30,000,State - GOA,Urban,0-6,43909,43909,0
C2308,30,000,State - GOA,Urban,7,6444,1068,5376
C2308,30,000,State - GOA,Urban,8,6099,385,5714
C2308,30,000,State - GOA,Urban,9,6424,304,6120
C2308,30,000,State - GOA,Urban,10,7074,340,6734
C2308,30,000,State - GOA,Urban,11,6785,234,6551
C2308,30,000,State - GOA,Urban,12,6377,182,6195
C2308,30,000,State - GOA,Urban,13,6532,163,6369
C2308,30,000,State - GOA,Urban,14,6442,161,6281
C2308,30,000,State - GOA,Urban,15,6526,208,6318
C2308,30,000,State - GOA,Urban,16,6253,184,6069
C2308,30,000,State - GOA,Urban,17,6280,188,6092
C2308,30,000,State - GOA,Urban,18,7212,305,6907
C2308,30,000,State - GOA,Urban,19,7158,284,6874
C2308,30,000,State - GOA,Urban,20-24,37429,2255,35174
C2308,30,000,State - GOA,Urban,25-29,40215,3204,37011
C2308,30,000,State - GOA,Urban,30-34,38334,3260,35074
C2308,30,000,State - GOA,Urban,35-39,38639,3954,34685
C2308,30,000,State - GOA,Urban,40-44,33188,4201,28987
C2308,30,000,State - GOA,Urban,45-49,29056,4500,24556
C2308,30,000,State - GOA,Urban,50-54,23201,4351,18850
C2308,30,000,State - GOA,Urban,55-59,20492,4599,15893
C2308,30,000,State - GOA,Urban,60-64,18988,6128,12860
C2308,30,000,State - GOA,Urban,65-69,12751,4728,8023
C2308,30,000,State - GOA,Urban,70-74,9356,3791,5565
C2308,30,000,State - GOA,Urban,75-79,5614,2094,3520
C2308,30,000,State - GOA,Urban,80+,5770,2449,3321
C2308,30,000,State - GOA,Urban,Age not stated,562,145,417
C2308,31,000,State - LAKSHADWEEP,Total,All ages,31350,6820,24530
C2308,31,000,State - LAKSHADWEEP,Total,0-6,3458,3458,0
C2308,31,000,State - LAKSHADWEEP,Total,7,545,167,378
C2308,31,000,State - LAKSHADWEEP,Total,8,455,40,415
C2308,31,000,State - LAKSHADWEEP,Total,9,593,41,552
C2308,31,000,State - LAKSHADWEEP,Total,10,678,41,637
C2308,31,000,State - LAKSHADWEEP,Total,11,643,18,625
C2308,31,000,State - LAKSHADWEEP,Total,12,624,8,616
C2308,31,000,State - LAKSHADWEEP,Total,13,631,2,629
C2308,31,000,State - LAKSHADWEEP,Total,14,568,9,559
C2308,31,000,State - LAKSHADWEEP,Total,15,573,3,570
C2308,31,000,State - LAKSHADWEEP,Total,16,603,8,595
C2308,31,000,State - LAKSHADWEEP,Total,17,588,10,578
C2308,31,000,State - LAKSHADWEEP,Total,18,561,10,551
C2308,31,000,State - LAKSHADWEEP,Total,19,491,10,481
C2308,31,000,State - LAKSHADWEEP,Total,20-24,2758,53,2705
C2308,31,000,State - LAKSHADWEEP,Total,25-29,2832,54,2778
C2308,31,000,State - LAKSHADWEEP,Total,30-34,2660,77,2583
C2308,31,000,State - LAKSHADWEEP,Total,35-39,2633,116,2517
C2308,31,000,State - LAKSHADWEEP,Total,40-44,2155,176,1979
C2308,31,000,State - LAKSHADWEEP,Total,45-49,1835,226,1609
C2308,31,000,State - LAKSHADWEEP,Total,50-54,1441,319,1122
C2308,31,000,State - LAKSHADWEEP,Total,55-59,1388,432,956
C2308,31,000,State - LAKSHADWEEP,Total,60-64,988,455,533
C2308,31,000,State - LAKSHADWEEP,Total,65-69,660,412,248
C2308,31,000,State - LAKSHADWEEP,Total,70-74,439,314,125
C2308,31,000,State - LAKSHADWEEP,Total,75-79,249,162,87
C2308,31,000,State - LAKSHADWEEP,Total,80+,260,186,74
C2308,31,000,State - LAKSHADWEEP,Total,Age not stated,41,13,28
C2308,31,000,State - LAKSHADWEEP,Rural,All ages,6898,1559,5339
C2308,31,000,State - LAKSHADWEEP,Rural,0-6,865,865,0
C2308,31,000,State - LAKSHADWEEP,Rural,7,136,61,75
C2308,31,000,State - LAKSHADWEEP,Rural,8,123,22,101
C2308,31,000,State - LAKSHADWEEP,Rural,9,137,12,125
C2308,31,000,State - LAKSHADWEEP,Rural,10,158,8,150
C2308,31,000,State - LAKSHADWEEP,Rural,11,168,5,163
C2308,31,000,State - LAKSHADWEEP,Rural,12,137,3,134
C2308,31,000,State - LAKSHADWEEP,Rural,13,164,1,163
C2308,31,000,State - LAKSHADWEEP,Rural,14,150,2,148
C2308,31,000,State - LAKSHADWEEP,Rural,15,124,0,124
C2308,31,000,State - LAKSHADWEEP,Rural,16,136,3,133
C2308,31,000,State - LAKSHADWEEP,Rural,17,122,2,120
C2308,31,000,State - LAKSHADWEEP,Rural,18,130,2,128
C2308,31,000,State - LAKSHADWEEP,Rural,19,110,2,108
C2308,31,000,State - LAKSHADWEEP,Rural,20-24,600,13,587
C2308,31,000,State - LAKSHADWEEP,Rural,25-29,623,8,615
C2308,31,000,State - LAKSHADWEEP,Rural,30-34,593,17,576
C2308,31,000,State - LAKSHADWEEP,Rural,35-39,526,21,505
C2308,31,000,State - LAKSHADWEEP,Rural,40-44,438,21,417
C2308,31,000,State - LAKSHADWEEP,Rural,45-49,357,24,333
C2308,31,000,State - LAKSHADWEEP,Rural,50-54,301,40,261
C2308,31,000,State - LAKSHADWEEP,Rural,55-59,279,81,198
C2308,31,000,State - LAKSHADWEEP,Rural,60-64,198,93,105
C2308,31,000,State - LAKSHADWEEP,Rural,65-69,144,109,35
C2308,31,000,State - LAKSHADWEEP,Rural,70-74,95,82,13
C2308,31,000,State - LAKSHADWEEP,Rural,75-79,42,33,9
C2308,31,000,State - LAKSHADWEEP,Rural,80+,35,28,7
C2308,31,000,State - LAKSHADWEEP,Rural,Age not stated,7,1,6
C2308,31,000,State - LAKSHADWEEP,Urban,All ages,24452,5261,19191
C2308,31,000,State - LAKSHADWEEP,Urban,0-6,2593,2593,0
C2308,31,000,State - LAKSHADWEEP,Urban,7,409,106,303
C2308,31,000,State - LAKSHADWEEP,Urban,8,332,18,314
C2308,31,000,State - LAKSHADWEEP,Urban,9,456,29,427
C2308,31,000,State - LAKSHADWEEP,Urban,10,520,33,487
C2308,31,000,State - LAKSHADWEEP,Urban,11,475,13,462
C2308,31,000,State - LAKSHADWEEP,Urban,12,487,5,482
C2308,31,000,State - LAKSHADWEEP,Urban,13,467,1,466
C2308,31,000,State - LAKSHADWEEP,Urban,14,418,7,411
C2308,31,000,State - LAKSHADWEEP,Urban,15,449,3,446
C2308,31,000,State - LAKSHADWEEP,Urban,16,467,5,462
C2308,31,000,State - LAKSHADWEEP,Urban,17,466,8,458
C2308,31,000,State - LAKSHADWEEP,Urban,18,431,8,423
C2308,31,000,State - LAKSHADWEEP,Urban,19,381,8,373
C2308,31,000,State - LAKSHADWEEP,Urban,20-24,2158,40,2118
C2308,31,000,State - LAKSHADWEEP,Urban,25-29,2209,46,2163
C2308,31,000,State - LAKSHADWEEP,Urban,30-34,2067,60,2007
C2308,31,000,State - LAKSHADWEEP,Urban,35-39,2107,95,2012
C2308,31,000,State - LAKSHADWEEP,Urban,40-44,1717,155,1562
C2308,31,000,State - LAKSHADWEEP,Urban,45-49,1478,202,1276
C2308,31,000,State - LAKSHADWEEP,Urban,50-54,1140,279,861
C2308,31,000,State - LAKSHADWEEP,Urban,55-59,1109,351,758
C2308,31,000,State - LAKSHADWEEP,Urban,60-64,790,362,428
C2308,31,000,State - LAKSHADWEEP,Urban,65-69,516,303,213
C2308,31,000,State - LAKSHADWEEP,Urban,70-74,344,232,112
C2308,31,000,State - LAKSHADWEEP,Urban,75-79,207,129,78
C2308,31,000,State - LAKSHADWEEP,Urban,80+,225,158,67
C2308,31,000,State - LAKSHADWEEP,Urban,Age not stated,34,12,22
C2308,32,000,State - KERALA,Total,All ages,17378649,2947728,14430921
C2308,32,000,State - KERALA,Total,0-6,1704711,1704711,0
C2308,32,000,State - KERALA,Total,7,249844,33307,216537
C2308,32,000,State - KERALA,Total,8,247863,7367,240496
C2308,32,000,State - KERALA,Total,9,255062,4321,250741
C2308,32,000,State - KERALA,Total,10,283995,5783,278212
C2308,32,000,State - KERALA,Total,11,278880,3223,275657
C2308,32,000,State - KERALA,Total,12,264832,2229,262603
C2308,32,000,State - KERALA,Total,13,285228,2299,282929
C2308,32,000,State - KERALA,Total,14,270918,2161,268757
C2308,32,000,State - KERALA,Total,15,265577,2281,263296
C2308,32,000,State - KERALA,Total,16,253505,2046,251459
C2308,32,000,State - KERALA,Total,17,254228,1894,252334
C2308,32,000,State - KERALA,Total,18,258075,2267,255808
C2308,32,000,State - KERALA,Total,19,250868,2109,248759
C2308,32,000,State - KERALA,Total,20-24,1366983,15103,1351880
C2308,32,000,State - KERALA,Total,25-29,1400114,21234,1378880
C2308,32,000,State - KERALA,Total,30-34,1327284,27128,1300156
C2308,32,000,State - KERALA,Total,35-39,1417854,49718,1368136
C2308,32,000,State - KERALA,Total,40-44,1295074,66397,1228677
C2308,32,000,State - KERALA,Total,45-49,1242932,101213,1141719
C2308,32,000,State - KERALA,Total,50-54,996954,106360,890594
C2308,32,000,State - KERALA,Total,55-59,880881,128975,751906
C2308,32,000,State - KERALA,Total,60-64,729535,147069,582466
C2308,32,000,State - KERALA,Total,65-69,542902,149897,393005
C2308,32,000,State - KERALA,Total,70-74,406810,126636,280174
C2308,32,000,State - KERALA,Total,75-79,293050,99108,193942
C2308,32,000,State - KERALA,Total,80+,337501,129249,208252
C2308,32,000,State - KERALA,Total,Age not stated,17189,3643,13546
C2308,32,000,State - KERALA,Rural,All ages,9063081,1646191,7416890
C2308,32,000,State - KERALA,Rural,0-6,895776,895776,0
C2308,32,000,State - KERALA,Rural,7,132302,18501,113801
C2308,32,000,State - KERALA,Rural,8,130816,4192,126624
C2308,32,000,State - KERALA,Rural,9,134764,2351,132413
C2308,32,000,State - KERALA,Rural,10,151068,3180,147888
C2308,32,000,State - KERALA,Rural,11,147734,1776,145958
C2308,32,000,State - KERALA,Rural,12,141597,1292,140305
C2308,32,000,State - KERALA,Rural,13,151908,1235,150673
C2308,32,000,State - KERALA,Rural,14,144134,1210,142924
C2308,32,000,State - KERALA,Rural,15,140291,1269,139022
C2308,32,000,State - KERALA,Rural,16,133506,1149,132357
C2308,32,000,State - KERALA,Rural,17,132410,1075,131335
C2308,32,000,State - KERALA,Rural,18,133994,1326,132668
C2308,32,000,State - KERALA,Rural,19,129408,1256,128152
C2308,32,000,State - KERALA,Rural,20-24,705778,9363,696415
C2308,32,000,State - KERALA,Rural,25-29,729997,13910,716087
C2308,32,000,State - KERALA,Rural,30-34,685286,18003,667283
C2308,32,000,State - KERALA,Rural,35-39,736288,34062,702226
C2308,32,000,State - KERALA,Rural,40-44,667921,44151,623770
C2308,32,000,State - KERALA,Rural,45-49,649445,66717,582728
C2308,32,000,State - KERALA,Rural,50-54,516245,66965,449280
C2308,32,000,State - KERALA,Rural,55-59,456523,79125,377398
C2308,32,000,State - KERALA,Rural,60-64,373570,87136,286434
C2308,32,000,State - KERALA,Rural,65-69,284728,87583,197145
C2308,32,000,State - KERALA,Rural,70-74,211313,71836,139477
C2308,32,000,State - KERALA,Rural,75-79,154915,56359,98556
C2308,32,000,State - KERALA,Rural,80+,182706,73510,109196
C2308,32,000,State - KERALA,Rural,Age not stated,8658,1883,6775
C2308,32,000,State - KERALA,Urban,All ages,8315568,1301537,7014031
C2308,32,000,State - KERALA,Urban,0-6,808935,808935,0
C2308,32,000,State - KERALA,Urban,7,117542,14806,102736
C2308,32,000,State - KERALA,Urban,8,117047,3175,113872
C2308,32,000,State - KERALA,Urban,9,120298,1970,118328
C2308,32,000,State - KERALA,Urban,10,132927,2603,130324
C2308,32,000,State - KERALA,Urban,11,131146,1447,129699
C2308,32,000,State - KERALA,Urban,12,123235,937,122298
C2308,32,000,State - KERALA,Urban,13,133320,1064,132256
C2308,32,000,State - KERALA,Urban,14,126784,951,125833
C2308,32,000,State - KERALA,Urban,15,125286,1012,124274
C2308,32,000,State - KERALA,Urban,16,119999,897,119102
C2308,32,000,State - KERALA,Urban,17,121818,819,120999
C2308,32,000,State - KERALA,Urban,18,124081,941,123140
C2308,32,000,State - KERALA,Urban,19,121460,853,120607
C2308,32,000,State - KERALA,Urban,20-24,661205,5740,655465
C2308,32,000,State - KERALA,Urban,25-29,670117,7324,662793
C2308,32,000,State - KERALA,Urban,30-34,641998,9125,632873
C2308,32,000,State - KERALA,Urban,35-39,681566,15656,665910
C2308,32,000,State - KERALA,Urban,40-44,627153,22246,604907
C2308,32,000,State - KERALA,Urban,45-49,593487,34496,558991
C2308,32,000,State - KERALA,Urban,50-54,480709,39395,441314
C2308,32,000,State - KERALA,Urban,55-59,424358,49850,374508
C2308,32,000,State - KERALA,Urban,60-64,355965,59933,296032
C2308,32,000,State - KERALA,Urban,65-69,258174,62314,195860
C2308,32,000,State - KERALA,Urban,70-74,195497,54800,140697
C2308,32,000,State - KERALA,Urban,75-79,138135,42749,95386
C2308,32,000,State - KERALA,Urban,80+,154795,55739,99056
C2308,32,000,State - KERALA,Urban,Age not stated,8531,1760,6771
C2308,33,000,State - TAMIL NADU,Total,All ages,36009055,12212039,23797016
C2308,33,000,State - TAMIL NADU,Total,0-6,3603556,3603556,0
C2308,33,000,State - TAMIL NADU,Total,7,554812,99928,454884
C2308,33,000,State - TAMIL NADU,Total,8,551476,38933,512543
C2308,33,000,State - TAMIL NADU,Total,9,554241,21504,532737
C2308,33,000,State - TAMIL NADU,Total,10,624299,22025,602274
C2308,33,000,State - TAMIL NADU,Total,11,588086,12829,575257
C2308,33,000,State - TAMIL NADU,Total,12,584365,10894,573471
C2308,33,000,State - TAMIL NADU,Total,13,601385,10875,590510
C2308,33,000,State - TAMIL NADU,Total,14,590422,11269,579153
C2308,33,000,State - TAMIL NADU,Total,15,615611,14719,600892
C2308,33,000,State - TAMIL NADU,Total,16,566844,12743,554101
C2308,33,000,State - TAMIL NADU,Total,17,572969,14816,558153
C2308,33,000,State - TAMIL NADU,Total,18,642072,22115,619957
C2308,33,000,State - TAMIL NADU,Total,19,626458,25269,601189
C2308,33,000,State - TAMIL NADU,Total,20-24,3256739,224758,3031981
C2308,33,000,State - TAMIL NADU,Total,25-29,3426372,444379,2981993
C2308,33,000,State - TAMIL NADU,Total,30-34,2906811,571916,2334895
C2308,33,000,State - TAMIL NADU,Total,35-39,3021251,931521,2089730
C2308,33,000,State - TAMIL NADU,Total,40-44,2514363,927392,1586971
C2308,33,000,State - TAMIL NADU,Total,45-49,2338141,1003583,1334558
C2308,33,000,State - TAMIL NADU,Total,50-54,1827897,851809,976088
C2308,33,000,State - TAMIL NADU,Total,55-59,1560218,808414,751804
C2308,33,000,State - TAMIL NADU,Total,60-64,1404569,849527,555042
C2308,33,000,State - TAMIL NADU,Total,65-69,971958,637972,333986
C2308,33,000,State - TAMIL NADU,Total,70-74,713362,497459,215903
C2308,33,000,State - TAMIL NADU,Total,75-79,356495,241241,115254
C2308,33,000,State - TAMIL NADU,Total,80+,402148,290513,111635
C2308,33,000,State - TAMIL NADU,Total,Age not stated,32135,10080,22055
C2308,33,000,State - TAMIL NADU,Rural,All ages,18550525,7714169,10836356
C2308,33,000,State - TAMIL NADU,Rural,0-6,1890752,1890752,0
C2308,33,000,State - TAMIL NADU,Rural,7,298429,57438,240991
C2308,33,000,State - TAMIL NADU,Rural,8,298331,22263,276068
C2308,33,000,State - TAMIL NADU,Rural,9,297330,12148,285182
C2308,33,000,State - TAMIL NADU,Rural,10,334127,12515,321612
C2308,33,000,State - TAMIL NADU,Rural,11,311955,7395,304560
C2308,33,000,State - TAMIL NADU,Rural,12,315128,6554,308574
C2308,33,000,State - TAMIL NADU,Rural,13,322518,6576,315942
C2308,33,000,State - TAMIL NADU,Rural,14,315266,6960,308306
C2308,33,000,State - TAMIL NADU,Rural,15,331287,9388,321899
C2308,33,000,State - TAMIL NADU,Rural,16,301539,8042,293497
C2308,33,000,State - TAMIL NADU,Rural,17,303289,9533,293756
C2308,33,000,State - TAMIL NADU,Rural,18,342640,14674,327966
C2308,33,000,State - TAMIL NADU,Rural,19,329110,16825,312285
C2308,33,000,State - TAMIL NADU,Rural,20-24,1656464,152787,1503677
C2308,33,000,State - TAMIL NADU,Rural,25-29,1708000,307703,1400297
C2308,33,000,State - TAMIL NADU,Rural,30-34,1405706,396341,1009365
C2308,33,000,State - TAMIL NADU,Rural,35-39,1519260,646348,872912
C2308,33,000,State - TAMIL NADU,Rural,40-44,1251772,642054,609718
C2308,33,000,State - TAMIL NADU,Rural,45-49,1195482,692658,502824
C2308,33,000,State - TAMIL NADU,Rural,50-54,936410,589269,347141
C2308,33,000,State - TAMIL NADU,Rural,55-59,813158,552526,260632
C2308,33,000,State - TAMIL NADU,Rural,60-64,757736,578436,179300
C2308,33,000,State - TAMIL NADU,Rural,65-69,532226,426245,105981
C2308,33,000,State - TAMIL NADU,Rural,70-74,386460,323636,62824
C2308,33,000,State - TAMIL NADU,Rural,75-79,178675,148238,30437
C2308,33,000,State - TAMIL NADU,Rural,80+,200214,170619,29595
C2308,33,000,State - TAMIL NADU,Rural,Age not stated,17261,6246,11015
C2308,33,000,State - TAMIL NADU,Urban,All ages,17458530,4497870,12960660
C2308,33,000,State - TAMIL NADU,Urban,0-6,1712804,1712804,0
C2308,33,000,State - TAMIL NADU,Urban,7,256383,42490,213893
C2308,33,000,State - TAMIL NADU,Urban,8,253145,16670,236475
C2308,33,000,State - TAMIL NADU,Urban,9,256911,9356,247555
C2308,33,000,State - TAMIL NADU,Urban,10,290172,9510,280662
C2308,33,000,State - TAMIL NADU,Urban,11,276131,5434,270697
C2308,33,000,State - TAMIL NADU,Urban,12,269237,4340,264897
C2308,33,000,State - TAMIL NADU,Urban,13,278867,4299,274568
C2308,33,000,State - TAMIL NADU,Urban,14,275156,4309,270847
C2308,33,000,State - TAMIL NADU,Urban,15,284324,5331,278993
C2308,33,000,State - TAMIL NADU,Urban,16,265305,4701,260604
C2308,33,000,State - TAMIL NADU,Urban,17,269680,5283,264397
C2308,33,000,State - TAMIL NADU,Urban,18,299432,7441,291991
C2308,33,000,State - TAMIL NADU,Urban,19,297348,8444,288904
C2308,33,000,State - TAMIL NADU,Urban,20-24,1600275,71971,1528304
C2308,33,000,State - TAMIL NADU,Urban,25-29,1718372,136676,1581696
C2308,33,000,State - TAMIL NADU,Urban,30-34,1501105,175575,1325530
C2308,33,000,State - TAMIL NADU,Urban,35-39,1501991,285173,1216818
C2308,33,000,State - TAMIL NADU,Urban,40-44,1262591,285338,977253
C2308,33,000,State - TAMIL NADU,Urban,45-49,1142659,310925,831734
C2308,33,000,State - TAMIL NADU,Urban,50-54,891487,262540,628947
C2308,33,000,State - TAMIL NADU,Urban,55-59,747060,255888,491172
C2308,33,000,State - TAMIL NADU,Urban,60-64,646833,271091,375742
C2308,33,000,State - TAMIL NADU,Urban,65-69,439732,211727,228005
C2308,33,000,State - TAMIL NADU,Urban,70-74,326902,173823,153079
C2308,33,000,State - TAMIL NADU,Urban,75-79,177820,93003,84817
C2308,33,000,State - TAMIL NADU,Urban,80+,201934,119894,82040
C2308,33,000,State - TAMIL NADU,Urban,Age not stated,14874,3834,11040
C2308,34,000,State - PUDUCHERRY,Total,All ages,635442,175511,459931
C2308,34,000,State - PUDUCHERRY,Total,0-6,65331,65331,0
C2308,34,000,State - PUDUCHERRY,Total,7,9887,2194,7693
C2308,34,000,State - PUDUCHERRY,Total,8,9571,898,8673
C2308,34,000,State - PUDUCHERRY,Total,9,9847,514,9333
C2308,34,000,State - PUDUCHERRY,Total,10,11035,490,10545
C2308,34,000,State - PUDUCHERRY,Total,11,10590,260,10330
C2308,34,000,State - PUDUCHERRY,Total,12,9943,143,9800
C2308,34,000,State - PUDUCHERRY,Total,13,10155,113,10042
C2308,34,000,State - PUDUCHERRY,Total,14,10067,132,9935
C2308,34,000,State - PUDUCHERRY,Total,15,10130,178,9952
C2308,34,000,State - PUDUCHERRY,Total,16,9454,134,9320
C2308,34,000,State - PUDUCHERRY,Total,17,9415,154,9261
C2308,34,000,State - PUDUCHERRY,Total,18,10536,211,10325
C2308,34,000,State - PUDUCHERRY,Total,19,10550,260,10290
C2308,34,000,State - PUDUCHERRY,Total,20-24,57532,2207,55325
C2308,34,000,State - PUDUCHERRY,Total,25-29,63192,4285,58907
C2308,34,000,State - PUDUCHERRY,Total,30-34,57309,6243,51066
C2308,34,000,State - PUDUCHERRY,Total,35-39,54804,10329,44475
C2308,34,000,State - PUDUCHERRY,Total,40-44,44297,11063,33234
C2308,34,000,State - PUDUCHERRY,Total,45-49,38680,12113,26567
C2308,34,000,State - PUDUCHERRY,Total,50-54,30065,9944,20121
C2308,34,000,State - PUDUCHERRY,Total,55-59,25494,9985,15509
C2308,34,000,State - PUDUCHERRY,Total,60-64,23330,11555,11775
C2308,34,000,State - PUDUCHERRY,Total,65-69,15829,9061,6768
C2308,34,000,State - PUDUCHERRY,Total,70-74,12660,7830,4830
C2308,34,000,State - PUDUCHERRY,Total,75-79,7295,4480,2815
C2308,34,000,State - PUDUCHERRY,Total,80+,7903,5220,2683
C2308,34,000,State - PUDUCHERRY,Total,Age not stated,541,184,357
C2308,34,000,State - PUDUCHERRY,Rural,All ages,200293,69901,130392
C2308,34,000,State - PUDUCHERRY,Rural,0-6,21716,21716,0
C2308,34,000,State - PUDUCHERRY,Rural,7,3361,867,2494
C2308,34,000,State - PUDUCHERRY,Rural,8,3188,408,2780
C2308,34,000,State - PUDUCHERRY,Rural,9,3309,223,3086
C2308,34,000,State - PUDUCHERRY,Rural,10,3737,217,3520
C2308,34,000,State - PUDUCHERRY,Rural,11,3535,111,3424
C2308,34,000,State - PUDUCHERRY,Rural,12,3334,47,3287
C2308,34,000,State - PUDUCHERRY,Rural,13,3468,46,3422
C2308,34,000,State - PUDUCHERRY,Rural,14,3305,52,3253
C2308,34,000,State - PUDUCHERRY,Rural,15,3411,72,3339
C2308,34,000,State - PUDUCHERRY,Rural,16,3115,47,3068
C2308,34,000,State - PUDUCHERRY,Rural,17,3036,58,2978
C2308,34,000,State - PUDUCHERRY,Rural,18,3554,80,3474
C2308,34,000,State - PUDUCHERRY,Rural,19,3509,80,3429
C2308,34,000,State - PUDUCHERRY,Rural,20-24,19117,829,18288
C2308,34,000,State - PUDUCHERRY,Rural,25-29,20398,1741,18657
C2308,34,000,State - PUDUCHERRY,Rural,30-34,17246,2703,14543
C2308,34,000,State - PUDUCHERRY,Rural,35-39,16756,4856,11900
C2308,34,000,State - PUDUCHERRY,Rural,40-44,12855,5092,7763
C2308,34,000,State - PUDUCHERRY,Rural,45-49,11610,5784,5826
C2308,34,000,State - PUDUCHERRY,Rural,50-54,8648,4688,3960
C2308,34,000,State - PUDUCHERRY,Rural,55-59,7629,4578,3051
C2308,34,000,State - PUDUCHERRY,Rural,60-64,7136,5069,2067
C2308,34,000,State - PUDUCHERRY,Rural,65-69,4982,3813,1169
C2308,34,000,State - PUDUCHERRY,Rural,70-74,3889,3202,687
C2308,34,000,State - PUDUCHERRY,Rural,75-79,1999,1603,396
C2308,34,000,State - PUDUCHERRY,Rural,80+,2210,1831,379
C2308,34,000,State - PUDUCHERRY,Rural,Age not stated,240,88,152
C2308,34,000,State - PUDUCHERRY,Urban,All ages,435149,105610,329539
C2308,34,000,State - PUDUCHERRY,Urban,0-6,43615,43615,0
C2308,34,000,State - PUDUCHERRY,Urban,7,6526,1327,5199
C2308,34,000,State - PUDUCHERRY,Urban,8,6383,490,5893
C2308,34,000,State - PUDUCHERRY,Urban,9,6538,291,6247
C2308,34,000,State - PUDUCHERRY,Urban,10,7298,273,7025
C2308,34,000,State - PUDUCHERRY,Urban,11,7055,149,6906
C2308,34,000,State - PUDUCHERRY,Urban,12,6609,96,6513
C2308,34,000,State - PUDUCHERRY,Urban,13,6687,67,6620
C2308,34,000,State - PUDUCHERRY,Urban,14,6762,80,6682
C2308,34,000,State - PUDUCHERRY,Urban,15,6719,106,6613
C2308,34,000,State - PUDUCHERRY,Urban,16,6339,87,6252
C2308,34,000,State - PUDUCHERRY,Urban,17,6379,96,6283
C2308,34,000,State - PUDUCHERRY,Urban,18,6982,131,6851
C2308,34,000,State - PUDUCHERRY,Urban,19,7041,180,6861
C2308,34,000,State - PUDUCHERRY,Urban,20-24,38415,1378,37037
C2308,34,000,State - PUDUCHERRY,Urban,25-29,42794,2544,40250
C2308,34,000,State - PUDUCHERRY,Urban,30-34,40063,3540,36523
C2308,34,000,State - PUDUCHERRY,Urban,35-39,38048,5473,32575
C2308,34,000,State - PUDUCHERRY,Urban,40-44,31442,5971,25471
C2308,34,000,State - PUDUCHERRY,Urban,45-49,27070,6329,20741
C2308,34,000,State - PUDUCHERRY,Urban,50-54,21417,5256,16161
C2308,34,000,State - PUDUCHERRY,Urban,55-59,17865,5407,12458
C2308,34,000,State - PUDUCHERRY,Urban,60-64,16194,6486,9708
C2308,34,000,State - PUDUCHERRY,Urban,65-69,10847,5248,5599
C2308,34,000,State - PUDUCHERRY,Urban,70-74,8771,4628,4143
C2308,34,000,State - PUDUCHERRY,Urban,75-79,5296,2877,2419
C2308,34,000,State - PUDUCHERRY,Urban,80+,5693,3389,2304
C2308,34,000,State - PUDUCHERRY,Urban,Age not stated,301,96,205
C2308,35,000,State - ANDAMAN & NICOBAR ISLANDS,Total,All ages,177710,47806,129904
C2308,35,000,State - ANDAMAN & NICOBAR ISLANDS,Total,0-6,20108,20108,0
C2308,35,000,State - ANDAMAN & NICOBAR ISLANDS,Total,7,3010,481,2529
C2308,35,000,State - ANDAMAN & NICOBAR ISLANDS,Total,8,2868,146,2722
C2308,35,000,State - ANDAMAN & NICOBAR ISLANDS,Total,9,3069,153,2916
C2308,35,000,State - ANDAMAN & NICOBAR ISLANDS,Total,10,3443,128,3315
C2308,35,000,State - ANDAMAN & NICOBAR ISLANDS,Total,11,3423,81,3342
C2308,35,000,State - ANDAMAN & NICOBAR ISLANDS,Total,12,3213,48,3165
C2308,35,000,State - ANDAMAN & NICOBAR ISLANDS,Total,13,3130,45,3085
C2308,35,000,State - ANDAMAN & NICOBAR ISLANDS,Total,14,3140,44,3096
C2308,35,000,State - ANDAMAN & NICOBAR ISLANDS,Total,15,3248,61,3187
C2308,35,000,State - ANDAMAN & NICOBAR ISLANDS,Total,16,3102,49,3053
C2308,35,000,State - ANDAMAN & NICOBAR ISLANDS,Total,17,3007,63,2944
C2308,35,000,State - ANDAMAN & NICOBAR ISLANDS,Total,18,3283,93,3190
C2308,35,000,State - ANDAMAN & NICOBAR ISLANDS,Total,19,3120,82,3038
C2308,35,000,State - ANDAMAN & NICOBAR ISLANDS,Total,20-24,17587,915,16672
C2308,35,000,State - ANDAMAN & NICOBAR ISLANDS,Total,25-29,19492,1568,17924
C2308,35,000,State - ANDAMAN & NICOBAR ISLANDS,Total,30-34,16364,1705,14659
C2308,35,000,State - ANDAMAN & NICOBAR ISLANDS,Total,35-39,15672,2636,13036
C2308,35,000,State - ANDAMAN & NICOBAR ISLANDS,Total,40-44,11922,3039,8883
C2308,35,000,State - ANDAMAN & NICOBAR ISLANDS,Total,45-49,10591,3525,7066
C2308,35,000,State - ANDAMAN & NICOBAR ISLANDS,Total,50-54,7586,2994,4592
C2308,35,000,State - ANDAMAN & NICOBAR ISLANDS,Total,55-59,5924,2708,3216
C2308,35,000,State - ANDAMAN & NICOBAR ISLANDS,Total,60-64,4569,2628,1941
C2308,35,000,State - ANDAMAN & NICOBAR ISLANDS,Total,65-69,2796,1734,1062
C2308,35,000,State - ANDAMAN & NICOBAR ISLANDS,Total,70-74,1720,1193,527
C2308,35,000,State - ANDAMAN & NICOBAR ISLANDS,Total,75-79,956,658,298
C2308,35,000,State - ANDAMAN & NICOBAR ISLANDS,Total,80+,1194,873,321
C2308,35,000,State - ANDAMAN & NICOBAR ISLANDS,Total,Age not stated,173,48,125
C2308,35,000,State - ANDAMAN & NICOBAR ISLANDS,Rural,All ages,110806,32741,78065
C2308,35,000,State - ANDAMAN & NICOBAR ISLANDS,Rural,0-6,13045,13045,0
C2308,35,000,State - ANDAMAN & NICOBAR ISLANDS,Rural,7,1858,359,1499
C2308,35,000,State - ANDAMAN & NICOBAR ISLANDS,Rural,8,1785,109,1676
C2308,35,000,State - ANDAMAN & NICOBAR ISLANDS,Rural,9,1934,110,1824
C2308,35,000,State - ANDAMAN & NICOBAR ISLANDS,Rural,10,2165,94,2071
C2308,35,000,State - ANDAMAN & NICOBAR ISLANDS,Rural,11,2210,61,2149
C2308,35,000,State - ANDAMAN & NICOBAR ISLANDS,Rural,12,2062,34,2028
C2308,35,000,State - ANDAMAN & NICOBAR ISLANDS,Rural,13,2056,33,2023
C2308,35,000,State - ANDAMAN & NICOBAR ISLANDS,Rural,14,2002,30,1972
C2308,35,000,State - ANDAMAN & NICOBAR ISLANDS,Rural,15,1993,37,1956
C2308,35,000,State - ANDAMAN & NICOBAR ISLANDS,Rural,16,1905,38,1867
C2308,35,000,State - ANDAMAN & NICOBAR ISLANDS,Rural,17,1855,52,1803
C2308,35,000,State - ANDAMAN & NICOBAR ISLANDS,Rural,18,2054,64,1990
C2308,35,000,State - ANDAMAN & NICOBAR ISLANDS,Rural,19,1918,51,1867
C2308,35,000,State - ANDAMAN & NICOBAR ISLANDS,Rural,20-24,10886,640,10246
C2308,35,000,State - ANDAMAN & NICOBAR ISLANDS,Rural,25-29,11883,1062,10821
C2308,35,000,State - ANDAMAN & NICOBAR ISLANDS,Rural,30-34,9866,1126,8740
C2308,35,000,State - ANDAMAN & NICOBAR ISLANDS,Rural,35-39,9378,1725,7653
C2308,35,000,State - ANDAMAN & NICOBAR ISLANDS,Rural,40-44,7038,2075,4963
C2308,35,000,State - ANDAMAN & NICOBAR ISLANDS,Rural,45-49,6441,2446,3995
C2308,35,000,State - ANDAMAN & NICOBAR ISLANDS,Rural,50-54,4688,2128,2560
C2308,35,000,State - ANDAMAN & NICOBAR ISLANDS,Rural,55-59,3773,1945,1828
C2308,35,000,State - ANDAMAN & NICOBAR ISLANDS,Rural,60-64,3203,2016,1187
C2308,35,000,State - ANDAMAN & NICOBAR ISLANDS,Rural,65-69,1992,1343,649
C2308,35,000,State - ANDAMAN & NICOBAR ISLANDS,Rural,70-74,1218,914,304
C2308,35,000,State - ANDAMAN & NICOBAR ISLANDS,Rural,75-79,654,504,150
C2308,35,000,State - ANDAMAN & NICOBAR ISLANDS,Rural,80+,865,677,188
C2308,35,000,State - ANDAMAN & NICOBAR ISLANDS,Rural,Age not stated,79,23,56
C2308,35,000,State - ANDAMAN & NICOBAR ISLANDS,Urban,All ages,66904,15065,51839
C2308,35,000,State - ANDAMAN & NICOBAR ISLANDS,Urban,0-6,7063,7063,0
C2308,35,000,State - ANDAMAN & NICOBAR ISLANDS,Urban,7,1152,122,1030
C2308,35,000,State - ANDAMAN & NICOBAR ISLANDS,Urban,8,1083,37,1046
C2308,35,000,State - ANDAMAN & NICOBAR ISLANDS,Urban,9,1135,43,1092
C2308,35,000,State - ANDAMAN & NICOBAR ISLANDS,Urban,10,1278,34,1244
C2308,35,000,State - ANDAMAN & NICOBAR ISLANDS,Urban,11,1213,20,1193
C2308,35,000,State - ANDAMAN & NICOBAR ISLANDS,Urban,12,1151,14,1137
C2308,35,000,State - ANDAMAN & NICOBAR ISLANDS,Urban,13,1074,12,1062
C2308,35,000,State - ANDAMAN & NICOBAR ISLANDS,Urban,14,1138,14,1124
C2308,35,000,State - ANDAMAN & NICOBAR ISLANDS,Urban,15,1255,24,1231
C2308,35,000,State - ANDAMAN & NICOBAR ISLANDS,Urban,16,1197,11,1186
C2308,35,000,State - ANDAMAN & NICOBAR ISLANDS,Urban,17,1152,11,1141
C2308,35,000,State - ANDAMAN & NICOBAR ISLANDS,Urban,18,1229,29,1200
C2308,35,000,State - ANDAMAN & NICOBAR ISLANDS,Urban,19,1202,31,1171
C2308,35,000,State - ANDAMAN & NICOBAR ISLANDS,Urban,20-24,6701,275,6426
C2308,35,000,State - ANDAMAN & NICOBAR ISLANDS,Urban,25-29,7609,506,7103
C2308,35,000,State - ANDAMAN & NICOBAR ISLANDS,Urban,30-34,6498,579,5919
C2308,35,000,State - ANDAMAN & NICOBAR ISLANDS,Urban,35-39,6294,911,5383
C2308,35,000,State - ANDAMAN & NICOBAR ISLANDS,Urban,40-44,4884,964,3920
C2308,35,000,State - ANDAMAN & NICOBAR ISLANDS,Urban,45-49,4150,1079,3071
C2308,35,000,State - ANDAMAN & NICOBAR ISLANDS,Urban,50-54,2898,866,2032
C2308,35,000,State - ANDAMAN & NICOBAR ISLANDS,Urban,55-59,2151,763,1388
C2308,35,000,State - ANDAMAN & NICOBAR ISLANDS,Urban,60-64,1366,612,754
C2308,35,000,State - ANDAMAN & NICOBAR ISLANDS,Urban,65-69,804,391,413
C2308,35,000,State - ANDAMAN & NICOBAR ISLANDS,Urban,70-74,502,279,223
C2308,35,000,State - ANDAMAN & NICOBAR ISLANDS,Urban,75-79,302,154,148
C2308,35,000,State - ANDAMAN & NICOBAR ISLANDS,Urban,80+,329,196,133
C2308,35,000,State - ANDAMAN & NICOBAR ISLANDS,Urban,Age not stated,94,25,69
